Rank,Release Group,Worldwide,Domestic,Foreign,filename,year,Domestic %,Foreign %
1,Avengers: Endgame,2797501328,858373000,1939128328,2019.csv,2019,0.30683560054417247,0.6931643994558275
2,Star Wars: Episode VII - The Force Awakens,2068223624,936662225,1131561399,2015.csv,2015,0.4528824707980417,0.5471175292019583
3,Avengers: Infinity War,2048359754,678815482,1369544272,2018.csv,2018,0.3313946589091205,0.6686053410908794
4,Spider-Man: No Way Home,1886073139,799073139,1087000000,2021.csv,2021,0.4236702821735059,0.5763297178264941
5,Jurassic World,1670400637,652270625,1018130012,2015.csv,2015,0.39048753368022093,0.6095124663197791
6,The Lion King,1656943394,543638043,1113305351,2019.csv,2019,0.32809693135479556,0.6719030686452044
7,The Avengers,1518812988,623357910,895455078,2012.csv,2012,0.41042440045291473,0.5895755995470853
8,Furious 7,1515047671,353007020,1162040651,2015.csv,2015,0.23300060239490641,0.7669993976050936
9,Frozen II,1450026933,477373578,972653355,2019.csv,2019,0.329217042205105,0.6707829577948949
10,Avengers: Age of Ultron,1402805868,459005868,943800000,2015.csv,2015,0.3272055517235689,0.6727944482764311
11,Black Panther,1346913161,700059566,646853595,2018.csv,2018,0.5197510769589992,0.4802489230410007
12,Star Wars: Episode VIII - The Last Jedi,1332539889,620181382,712358507,2017.csv,2017,0.465412995978239,0.5345870040217611
13,Jurassic World: Fallen Kingdom,1308467944,417719760,890748184,2018.csv,2018,0.3192434036427567,0.6807565963572433
14,Frozen,1280802282,400738009,880064273,2013.csv,2013,0.31288046143565507,0.6871195385643449
15,Beauty and the Beast,1263521126,504014165,759506961,2017.csv,2017,0.3988965080430321,0.6011034919569679
16,Incredibles 2,1242805359,608581744,634223615,2018.csv,2018,0.48968387494698595,0.510316125053014
17,The Fate of the Furious,1236005118,226008385,1009996733,2017.csv,2017,0.1828539232634472,0.8171460767365528
18,Iron Man 3,1214811252,409013994,805797258,2013.csv,2013,0.33668933616363966,0.6633106638363603
19,Minions,1159398397,336045770,823352627,2015.csv,2015,0.28984494964762314,0.7101550503523768
20,Captain America: Civil War,1153296293,408084349,745211944,2016.csv,2016,0.35384172434862754,0.6461582756513724
21,Aquaman,1148461807,335061807,813400000,2018.csv,2018,0.2917483236776023,0.7082516763223977
22,Spider-Man: Far from Home,1131927996,390532085,741395911,2019.csv,2019,0.345014953583673,0.654985046416327
23,Captain Marvel,1128274794,426829839,701444955,2019.csv,2019,0.3783030882811692,0.6216969117188308
24,Skyfall,1108561013,304360277,804200736,2012.csv,2012,0.2745543758356943,0.7254456241643057
25,Transformers: Age of Extinction,1104054072,245439076,858614996,2014.csv,2014,0.22230711540729683,0.7776928845927031
26,The Dark Knight Rises,1081041287,448139099,632902188,2012.csv,2012,0.4145439257399981,0.5854560742600019
27,Joker,1074251311,335451311,738800000,2019.csv,2019,0.3122652097931673,0.6877347902068327
28,Star Wars: Episode IX - The Rise of Skywalker,1074144248,515202542,558941706,2019.csv,2019,0.4796399952420543,0.5203600047579457
29,Toy Story 4,1073394593,434038008,639356585,2019.csv,2019,0.4043601587249657,0.5956398412750342
30,Rogue One: A Star Wars Story,1056057273,532177324,523879949,2016.csv,2016,0.5039284682810948,0.49607153171890517
31,Aladdin,1050693953,355559216,695134737,2019.csv,2019,0.3384041708670612,0.6615958291329388
32,Despicable Me 3,1034799409,264624300,770175109,2017.csv,2017,0.2557252136969475,0.7442747863030524
33,Finding Dory,1028570889,486295561,542275328,2016.csv,2016,0.47278759898871686,0.5272124010112832
34,Zootopia,1023784195,341268248,682515947,2016.csv,2016,0.3333400238709487,0.6666599761290513
35,The Hobbit: An Unexpected Journey,1017003568,303003568,714000000,2012.csv,2012,0.29793756633113405,0.7020624336688659
36,Despicable Me 2,970766005,368065385,602700620,2013.csv,2013,0.3791494377679614,0.6208505622320386
37,The Jungle Book,966550600,364001123,602549477,2016.csv,2016,0.3765981036067848,0.6234018963932152
38,Jumanji: Welcome to the Jungle,962077546,404515480,557562066,2017.csv,2017,0.42046036900231326,0.5795396309976868
39,The Hobbit: The Desolation of Smaug,958366855,258366855,700000000,2013.csv,2013,0.2695907664711547,0.7304092335288452
40,The Hobbit: The Battle of the Five Armies,956019788,255119788,700900000,2014.csv,2014,0.26685617934092387,0.7331438206590761
41,Bohemian Rhapsody,903655259,216428042,687227217,2018.csv,2018,0.23950288546929155,0.7604971145307085
42,The Battle at Lake Changjin,902540935,342411,902198524,2021.csv,2021,0.00037938556216289516,0.9996206144378371
43,Spectre,880674609,200074609,680600000,2015.csv,2015,0.22718335121207064,0.7728166487879293
44,Spider-Man: Homecoming,880166924,334201140,545965784,2017.csv,2017,0.37970199843592395,0.620298001564076
45,Ice Age 4: Continental Drift,877244782,161321843,715922939,2012.csv,2012,0.18389604168657225,0.8161039583134277
46,The Secret Life of Pets,875457937,368384330,507073607,2016.csv,2016,0.42079043941548044,0.5792095605845196
47,Batman v Superman: Dawn of Justice,873634919,330360194,543274725,2016.csv,2016,0.3781444477724682,0.6218555522275317
48,Wolf Warrior 2,870325439,2721100,867604339,2017.csv,2017,0.003126531614572282,0.9968734683854277
49,The Hunger Games: Catching Fire,865011746,424668047,440343699,2013.csv,2013,0.490939052520103,0.5090609474798969
50,Guardians of the Galaxy Vol. 2,863756051,389813101,473942950,2017.csv,2017,0.4512999944240043,0.5487000055759956
51,Inside Out,857611174,356461711,501149463,2015.csv,2015,0.4156449004009829,0.5843550995990171
52,Venom,856085151,213515506,642569645,2018.csv,2018,0.24940919224050412,0.7505908077594958
53,Thor: Ragnarok,853977126,315058289,538918837,2017.csv,2017,0.36893059475225337,0.6310694052477467
54,The Twilight Saga: Breaking Dawn - Part 2,829746820,292324737,537422083,2012.csv,2012,0.35230594436023266,0.6476940556397673
55,"Hi, Mom",822009764,0,822009764,2021.csv,2021,0.0,1.0
56,Wonder Woman,821847012,412563408,409283604,2017.csv,2017,0.501995385973369,0.49800461402663104
57,Fantastic Beasts and Where to Find Them,814037575,234037575,580000000,2016.csv,2016,0.287502177034027,0.7124978229659731
58,Coco,807816196,210460015,597356181,2017.csv,2017,0.2605295809147159,0.7394704190852841
59,Jumanji: The Next Level,800059707,320314960,479744747,2019.csv,2019,0.4003638193467978,0.5996361806532021
60,Pirates of the Caribbean: Dead Men Tell No Tales,794861794,172558876,622302918,2017.csv,2017,0.21709293024593404,0.782907069754066
61,Mission: Impossible - Fallout,791115104,220159104,570956000,2018.csv,2018,0.27828959766643513,0.7217104023335649
62,Fast & Furious 6,788679850,238679850,550000000,2013.csv,2013,0.30263211365169274,0.6973678863483073
63,Deadpool,782612155,363070709,419541446,2016.csv,2016,0.463921633059737,0.536078366940263
64,No Time to Die,774153007,160891007,613262000,2021.csv,2021,0.20782843384344046,0.7921715661565596
65,Guardians of the Galaxy,772776600,333176600,439600000,2014.csv,2014,0.4311421955581988,0.5688578044418011
66,Fast & Furious Presents: Hobbs & Shaw,759056935,173956935,585100000,2019.csv,2019,0.22917508157671992,0.77082491842328
67,Maleficent,758410378,241410378,517000000,2014.csv,2014,0.31831101604466705,0.681688983955333
68,The Amazing Spider-Man,757930663,262030663,495900000,2012.csv,2012,0.34571851462354675,0.6542814853764533
69,The Hunger Games: Mockingjay - Part 1,755356711,337135885,418220826,2014.csv,2014,0.44632672231596815,0.5536732776840319
70,Madagascar 3: Europe's Most Wanted,746921274,216391482,530529792,2012.csv,2012,0.2897112313338661,0.7102887686661339
71,Suicide Squad,746846894,325100054,421746840,2016.csv,2016,0.43529678788488074,0.5647032121151193
72,X-Men: Days of Future Past,746045700,233921534,512124166,2014.csv,2014,0.3135485319465014,0.6864514680534985
73,Monsters University,743559607,268492764,475066843,2013.csv,2013,0.3610911102114238,0.6389088897885762
74,Deadpool 2,734546611,318491426,416055185,2018.csv,2018,0.43358912998919275,0.5664108700108073
75,F9: The Fast Saga,726229501,173005945,553223556,2021.csv,2021,0.23822489276705933,0.7617751072329407
76,Ne Zha,726063471,3695533,722367938,2019.csv,2019,0.005089820859476899,0.9949101791405232
77,Gravity,723192705,274092705,449100000,2013.csv,2013,0.37900369169238235,0.6209963083076177
78,Captain America: The Winter Soldier,714421503,259766572,454654931,2014.csv,2014,0.3636040781376089,0.6363959218623911
79,Dawn of the Planet of the Apes,710644566,208545589,502098977,2014.csv,2014,0.29345976734028806,0.7065402326597119
80,The Amazing Spider-Man 2,708982323,202853933,506128390,2014.csv,2014,0.28611987410580336,0.7138801258941967
81,It,700381748,327481748,372900000,2017.csv,2017,0.4675760739555994,0.5324239260444006
82,The Wandering Earth,699856699,5971413,693885286,2019.csv,2019,0.008532336703402763,0.9914676632965972
83,The Hunger Games,694394724,408010692,286384032,2012.csv,2012,0.5875774655223331,0.4124225344776669
84,Detective Chinatown 3,686257563,0,686257563,2021.csv,2021,0.0,1.0
85,Mission: Impossible - Rogue Nation,682714267,195042377,487671890,2015.csv,2015,0.2856866868434727,0.7143133131565274
86,Interstellar,677896797,188020017,489876780,2014.csv,2014,0.2773578778245798,0.7226421221754201
87,Doctor Strange,677718395,232641920,445076475,2016.csv,2016,0.3432722524817996,0.6567277475182004
88,Man of Steel,668045518,291045518,377000000,2013.csv,2013,0.4356671965577052,0.5643328034422948
89,The Hunger Games: Mockingjay - Part 2,658344137,281723902,376620235,2015.csv,2015,0.4279280184430351,0.5720719815569649
90,Justice League,657924295,229024295,428900000,2017.csv,2017,0.3481012887660578,0.6518987112339422
91,Big Hero 6,657827828,222527828,435300000,2014.csv,2014,0.33827670178769026,0.6617232982123098
92,Fantastic Beasts: The Crimes of Grindelwald,654855901,159555901,495300000,2018.csv,2018,0.24365039813545178,0.7563496018645482
93,Thor: The Dark World,644783140,206362140,438421000,2013.csv,2013,0.32004890822672566,0.6799510917732744
94,Moana,643331111,248757044,394574067,2016.csv,2016,0.38667031602642327,0.6133296839735767
95,Sing,634151679,270395425,363756254,2016.csv,2016,0.42638919670825315,0.5736108032917469
96,The Martian,630161890,228433663,401728227,2015.csv,2015,0.36249996488997455,0.6375000351100255
97,Water Gate Bridge,626203271,117294,626085977,2022.csv,2022,0.0001873097849084854,0.9998126902150916
98,Men in Black 3,624026776,179020854,445005922,2012.csv,2012,0.2868800841328001,0.7131199158671999
99,Ant-Man and the Wasp,622674139,216648740,406025399,2018.csv,2018,0.3479327732285988,0.6520672267714012
100,How to Train Your Dragon 2,621537519,177002924,444534595,2014.csv,2014,0.2847823640393944,0.7152176359606056
101,Logan,619021436,226277068,392744368,2017.csv,2017,0.36553995522701094,0.6344600447729891
102,The Batman,617351000,316951000,300400000,2022.csv,2022,0.5134048539647623,0.4865951460352377
103,Life of Pi,609016565,124987023,484029542,2012.csv,2012,0.20522762463776334,0.7947723753622367
104,Transformers: The Last Knight,605425157,130168683,475256474,2017.csv,2017,0.21500375644284633,0.7849962435571537
105,The Croods,587204668,187168425,400036243,2013.csv,2013,0.3187447838885368,0.6812552161114632
106,Ready Player One,582890172,137690172,445200000,2018.csv,2018,0.23621975221774713,0.7637802477822528
107,Operation Red Sea,579330426,1543547,577786879,2018.csv,2018,0.0026643637736368433,0.9973356362263631
108,Fifty Shades of Grey,569651467,166167230,403484237,2015.csv,2015,0.2916998193212763,0.7083001806787237
109,Kong: Skull Island,566652812,168052812,398600000,2017.csv,2017,0.29657103686975084,0.7034289631302492
110,The Mermaid,553810228,3232685,550577543,2016.csv,2016,0.005837170995693492,0.9941628290043065
111,Ted,549368315,218815487,330552828,2012.csv,2012,0.398303799155217,0.6016962008447829
112,American Sniper,547426372,350126372,197300000,2014.csv,2014,0.639586234621521,0.3604137653784791
113,Detective Chinatown 2,544185156,1983984,542201172,2018.csv,2018,0.0036457885301083076,0.9963542114698917
114,X-Men: Apocalypse,543934105,155442489,388491616,2016.csv,2016,0.285774485495812,0.7142255145041879
115,Cinderella,542351353,201151353,341200000,2015.csv,2015,0.3708875286976559,0.6291124713023442
116,World War Z,540007876,202359711,337648165,2013.csv,2013,0.37473473997997764,0.6252652600200224
117,Brave,538983207,237283207,301700000,2012.csv,2012,0.4402423005360907,0.5597576994639093
118,The Revenant,532950503,183637894,349312609,2015.csv,2015,0.34456838480552104,0.6554316151944789
119,The Meg,530243742,145443742,384800000,2018.csv,2018,0.2742960085703378,0.7257039914296621
120,Ralph Breaks the Internet,529323962,201091711,328232251,2018.csv,2018,0.3799029052835511,0.6200970947164489
121,Hotel Transylvania 3: Summer Vacation,528583774,167510016,361073758,2018.csv,2018,0.31690343941583043,0.6830965605841696
122,The Boss Baby,527965936,175003033,352962903,2017.csv,2017,0.331466522870521,0.6685334771294791
123,Dunkirk,525245546,188045546,337200000,2017.csv,2017,0.3580145465907482,0.6419854534092517
124,Godzilla,524976069,200676069,324300000,2014.csv,2014,0.38225755582013016,0.6177424441798699
125,How to Train Your Dragon: The Hidden World,521799505,160799505,361000000,2019.csv,2019,0.3081633912243746,0.6918366087756255
126,Kung Fu Panda 3,521170825,143528619,377642206,2016.csv,2016,0.2753964959569638,0.7246035040430362
127,Ant-Man,519311965,180202163,339109802,2015.csv,2015,0.3470017545234106,0.6529982454765894
128,The Grinch,511595957,270620950,240975007,2018.csv,2018,0.5289739809261237,0.4710260190738763
129,Venom: Let There Be Carnage,502050366,213550366,288500000,2021.csv,2021,0.42535645915653014,0.5746435408434699
130,Rio 2,498781117,131538435,367242682,2014.csv,2014,0.2637197570572825,0.7362802429427175
131,Oz the Great and Powerful,493311825,234911825,258400000,2013.csv,2013,0.47619337930932426,0.5238066206906757
132,Maleficent: Mistress of Evil,491730089,113929605,377800484,2019.csv,2019,0.23169134358178353,0.7683086564182164
133,War for the Planet of the Apes,490719763,146880162,343839601,2017.csv,2017,0.2993157665019495,0.7006842334980505
134,Teenage Mutant Ninja Turtles,485004754,191204754,293800000,2014.csv,2014,0.39423274189184543,0.6057672581081546
135,Hotel Transylvania 2,474800000,169700110,305099890,2015.csv,2015,0.3574138795282224,0.6425861204717775
136,San Andreas,473990832,155190832,318800000,2015.csv,2015,0.32741315131597315,0.6725868486840269
137,It Chapter Two,473093228,211593228,261500000,2019.csv,2019,0.44725482310222375,0.5527451768977762
138,Wreck-It Ralph,471222889,189422889,281800000,2012.csv,2012,0.40198151113156133,0.5980184888684387
139,Godzilla vs. Kong,468216094,100916094,367300000,2021.csv,2021,0.2155331593535527,0.7844668406464473
140,The Lego Movie,468060692,257760692,210300000,2014.csv,2014,0.5506992926464331,0.44930070735356686
141,Bumblebee,467989645,127195589,340794056,2018.csv,2018,0.2717914602576303,0.7282085397423698
142,Star Trek Into Darkness,467365246,228778661,238586585,2013.csv,2013,0.4895072172311246,0.5104927827688753
143,The Eight Hundred,461421559,372755,461048804,2020.csv,2020,0.0008078404502985089,0.9991921595497015
144,Lucy,458863600,126663600,332200000,2014.csv,2014,0.27603758502526676,0.7239624149747332
145,Demon Slayer the Movie: Mugen Train,454779627,49505008,405274619,2020.csv,2020,0.10885493777846825,0.8911450622215318
146,Dying to Survive,451176639,0,451176639,2018.csv,2018,0.0,1.0
147,"My People, My Country",450064993,2356683,447708310,2019.csv,2019,0.005236317057878794,0.9947636829421213
148,La La Land,447407695,151101803,296305892,2016.csv,2016,0.3377273227274287,0.6622726772725712
149,Les Misérables,442299309,148809770,293489539,2012.csv,2012,0.3364458568484899,0.6635541431515101
150,Terminator Genisys,440603537,89760956,350842581,2015.csv,2015,0.20372273134974855,0.7962772686502514
151,Warcraft,439048914,47365290,391683624,2016.csv,2016,0.10788157877097038,0.8921184212290296
152,A Star Is Born,436188866,215288866,220900000,2018.csv,2018,0.4935679995096436,0.5064320004903564
153,The Greatest Showman,434993183,174340174,260653009,2017.csv,2017,0.4007882900546513,0.5992117099453488
154,Pokémon Detective Pikachu,433005346,144105346,288900000,2019.csv,2019,0.3328026947731957,0.6671973052268043
155,Shang-Chi and the Legend of the Ten Rings,432243292,224543292,207700000,2021.csv,2021,0.5194835782437082,0.48051642175629183
156,The Secret Life of Pets 2,430051293,158874395,271176898,2019.csv,2019,0.36943126921374003,0.63056873078626
157,Rampage,428028233,101028233,327000000,2018.csv,2018,0.2360317035441912,0.7639682964558088
158,Bad Boys for Life,426505244,206305244,220200000,2020.csv,2020,0.4837109200936343,0.5162890799063657
159,Django Unchained,425368238,162805434,262562804,2012.csv,2012,0.38273998727662406,0.6172600127233759
160,"My People, My Homeland",422390820,0,422390820,2020.csv,2020,0.0,1.0
161,The Captain,417282021,706572,416575449,2019.csv,2019,0.0016932720904359309,0.9983067279095641
162,Jason Bourne,415484914,162434410,253050504,2016.csv,2016,0.39095140287091146,0.6090485971290885
163,The Wolverine,414828246,132556852,282271394,2013.csv,2013,0.3195463502743253,0.6804536497256747
164,Kingsman: The Secret Service,414351546,128261724,286089822,2015.csv,2015,0.3095480763573644,0.6904519236426355
165,Pacific Rim,411002906,101802906,309200000,2013.csv,2013,0.24769388370212642,0.7523061162978736
166,Kingsman: The Golden Circle,410902662,100234838,310667824,2017.csv,2017,0.24393815681826855,0.7560618431817314
167,The Mummy,409231607,80227895,329003712,2017.csv,2017,0.196045206742792,0.803954793257208
168,Ice Age 5: Collision Course,408579038,64063008,344516030,2016.csv,2016,0.15679465180981703,0.843205348190183
169,Alita: Battle Angel,404980543,85838210,319142333,2019.csv,2019,0.21195638033405473,0.7880436196659453
170,Prometheus,403354469,126477084,276877385,2012.csv,2012,0.3135631156227502,0.6864368843772498
171,Eternals,402064899,164870234,237194665,2021.csv,2021,0.41005876019035425,0.5899412398096457
172,Dune,400605070,108261111,292343959,2021.csv,2021,0.2702439861782079,0.7297560138217921
173,Snow White and the Huntsman,396592829,155332381,241260448,2012.csv,2012,0.39166714484391246,0.6083328551560876
174,Mamma Mia! Here We Go Again,395044706,120634935,274409771,2018.csv,2018,0.3053703369967449,0.6946296630032551
175,Solo: A Star Wars Story,392924807,213767512,179157295,2018.csv,2018,0.5440417815106289,0.4559582184893712
176,The Wolf of Wall Street,392000694,116900694,275100000,2013.csv,2013,0.2982155281592435,0.7017844718407565
177,Independence Day: Resurgence,389681935,103144286,286537649,2016.csv,2016,0.26468839516514925,0.7353116048348508
178,Monster Hunt,387053506,32766,387020740,2015.csv,2015,8.465496240718718e-05,0.9999153450375928
179,Godzilla: King of the Monsters,386600138,110500138,276100000,2019.csv,2019,0.2858253971963145,0.7141746028036855
180,Home,386041607,177397510,208644097,2015.csv,2015,0.45952950869360565,0.5404704913063944
181,1917,384919389,159227644,225691745,2019.csv,2019,0.4136649089401937,0.5863350910598063
182,Cars 3,383930656,152901115,231029541,2017.csv,2017,0.3982519046356121,0.6017480953643879
183,Fifty Shades Darker,381545846,114581250,266964596,2017.csv,2017,0.3003079477898444,0.6996920522101556
184,Black Widow,379751655,183651655,196100000,2021.csv,2021,0.4836098870984512,0.5163901129015488
185,Sing 2,377926880,159256880,218670000,2021.csv,2021,0.42139601184229075,0.5786039881577092
186,Taken 2,376141306,139854287,236287019,2012.csv,2012,0.3718131584304118,0.6281868415695883
187,G.I. Joe: Retaliation,375740705,122523060,253217645,2013.csv,2013,0.3260840743884802,0.6739159256115198
188,Spider-Man: Into the Spider-Verse,375540831,190241310,185299521,2018.csv,2018,0.5065795628491859,0.49342043715081413
189,Mad Max: Fury Road,374736354,153636354,221100000,2015.csv,2015,0.4099851865453118,0.5900148134546882
190,Once Upon a Time... In Hollywood,374375059,142502728,231872331,2019.csv,2019,0.3806416174748436,0.6193583825251564
191,Penguins of Madagascar,373515621,83850911,289664710,2014.csv,2014,0.22449104210289508,0.775508957897105
192,Fifty Shades Freed,371985018,100407760,271577258,2018.csv,2018,0.26992420431298125,0.7300757956870187
193,Edge of Tomorrow,370541256,100206256,270335000,2014.csv,2014,0.2704321162013873,0.7295678837986127
194,Gone Girl,369330363,167767189,201563174,2014.csv,2014,0.4542469447604014,0.5457530552395986
195,Hello Mr. Billionaire,366961907,0,366961907,2018.csv,2018,0.0,1.0
196,Shazam!,365971656,140371656,225600000,2019.csv,2019,0.3835588185550632,0.6164411814449369
197,The Nun,365550119,117450119,248100000,2018.csv,2018,0.32129689718415877,0.6787031028158412
198,Tenet,363704105,58504105,305200000,2020.csv,2020,0.16085632302665376,0.8391436769733462
199,Night at the Museum: Secret of the Tomb,363204635,113746621,249458014,2014.csv,2014,0.313175025973994,0.6868249740260061
200,The Hangover Part III,362000072,112200072,249800000,2013.csv,2013,0.3099448886297459,0.6900551113702541
201,Monster Hunt 2,361682618,706153,360976465,2018.csv,2018,0.0019524106629862981,0.9980475893370137
202,Noah,359200044,101200044,258000000,2014.csv,2014,0.28173728174710355,0.7182627182528964
203,Hotel Transylvania,358375603,148313048,210062555,2012.csv,2012,0.4138480598524448,0.5861519401475552
204,Your Name.,357986087,5017246,352968841,2016.csv,2016,0.014015198305737508,0.9859848016942625
205,The Legend of Tarzan,356700357,126643061,230057296,2016.csv,2016,0.3550404660794887,0.6449595339205113
206,The Great Gatsby,353641895,144840419,208801476,2013.csv,2013,0.40956804340164504,0.5904319565983549
207,Dumbo,353284621,114766307,238518314,2019.csv,2019,0.32485508900768145,0.6751449109923185
208,Murder on the Orient Express,352789811,102826543,249963268,2017.csv,2017,0.29146687289106543,0.7085331271089346
209,The Angry Birds Movie,352333929,107509366,244824563,2016.csv,2016,0.3051348653964007,0.6948651346035993
210,Now You See Me,351723989,117723989,234000000,2013.csv,2013,0.3347056006464205,0.6652943993535795
211,Peter Rabbit,351266433,115253424,236013009,2018.csv,2018,0.3281082767165515,0.6718917232834485
212,Titanic 2012 3D Release,350449521,57884114,292565407,2012.csv,2012,0.16517104613191924,0.8348289538680808
213,Mary Poppins Returns,349537494,171958438,177579056,2018.csv,2018,0.4919599211865952,0.5080400788134047
214,The Lorax,348840316,214030500,134809816,2012.csv,2012,0.6135486358176558,0.3864513641823441
215,The Maze Runner,348319861,102427862,245891999,2014.csv,2014,0.2940626517992323,0.7059373482007677
216,The Smurfs 2,347545360,71017784,276527576,2013.csv,2013,0.2043410506185437,0.7956589493814563
217,Trolls,346864462,153707064,193157398,2016.csv,2016,0.44313292608223437,0.5568670739177656
218,xXx: Return of Xander Cage,346118277,44898413,301219864,2017.csv,2017,0.12971985585147242,0.8702801441485276
219,Star Trek Beyond,343471816,158848340,184623476,2016.csv,2016,0.462478528369268,0.537521471630732
220,Uncharted,341265542,129865542,211400000,2022.csv,2022,0.3805410333516766,0.6194589666483233
221,A Quiet Place,340939361,188024361,152915000,2018.csv,2018,0.5514891576276522,0.44851084237234784
222,300: Rise of an Empire,337580051,106580051,231000000,2014.csv,2014,0.31571785916935,0.68428214083065
223,Journey 2: The Mysterious Island,335260290,103860290,231400000,2012.csv,2012,0.30979001420060814,0.6902099857993919
224,The Great Wall,334933831,45540830,289393001,2016.csv,2016,0.13596963276008986,0.8640303672399101
225,Now You See Me 2,334897606,65075540,269822066,2016.csv,2016,0.19431473630778956,0.8056852636922105
226,Never Say Die,334530869,0,334530869,2017.csv,2017,0.0,1.0
227,The Good Dinosaur,332207671,123087120,209120551,2015.csv,2015,0.3705125761530052,0.6294874238469947
228,Free Guy,331526598,121626598,209900000,2021.csv,2021,0.36686829573776764,0.6331317042622324
229,22 Jump Street,331333876,191719337,139614539,2014.csv,2014,0.5786288420445123,0.4213711579554878
230,Crazy Alien,327598891,0,327598891,2019.csv,2019,0.0,1.0
231,John Wick: Chapter 3 - Parabellum,326709727,171015687,155694040,2019.csv,2019,0.5234484096030603,0.47655159039693973
232,Taken 3,326479141,89256424,237222717,2015.csv,2015,0.27339089329446625,0.7266091067055338
233,The SpongeBob Movie: Sponge Out of Water,325186032,162994032,162192000,2015.csv,2015,0.5012331894993571,0.4987668105006429
234,Green Book,321752656,85080171,236672485,2018.csv,2018,0.26442725308847176,0.7355727469115282
235,The Conjuring 2,320392818,102470008,217922810,2016.csv,2016,0.31982617038562955,0.6801738296143705
236,Sonic the Hedgehog,319715683,148974665,170741018,2020.csv,2020,0.46595982906475064,0.5340401709352494
237,The Conjuring,319494638,137400141,182094497,2013.csv,2013,0.4300546070510266,0.5699453929489734
238,The Expendables 2,314975955,85028192,229947763,2012.csv,2012,0.26995137454222495,0.730048625457775
239,Maze Runner: The Scorch Trials,312296056,81697192,230598864,2015.csv,2015,0.2616017411375826,0.7383982588624174
240,Resident Evil: The Final Chapter,312242626,26830068,285412558,2016.csv,2016,0.085926986791355,0.914073013208645
241,The Lego Batman Movie,311950384,175750384,136200000,2017.csv,2017,0.5633921066114155,0.4366078933885845
242,Knives Out,311605581,165363234,146242347,2019.csv,2019,0.5306812332093628,0.46931876679063717
243,The Ex-File 3: The Return of The Exes,307592427,838959,306753468,2017.csv,2017,0.002727502130603495,0.9972724978693965
244,The Fault in Our Stars,307166834,124872350,182294484,2014.csv,2014,0.40652940414784494,0.593470595852155
245,Rise of the Guardians,306941670,103412758,203528912,2012.csv,2012,0.33691338813657984,0.6630866118634202
246,Annabelle: Creation,306515884,102092201,204423683,2017.csv,2017,0.33307311734617967,0.6669268826538203
247,Wonder,305937718,132422809,173514909,2017.csv,2017,0.43284237676114196,0.5671576232388581
248,Skyscraper,304868961,68420120,236448841,2018.csv,2018,0.22442468323300382,0.7755753167669962
249,A Good Day to Die Hard,304654182,67349198,237304984,2013.csv,2013,0.22106769569964413,0.7789323043003559
250,Dangal,303723636,12391761,291331875,2016.csv,2016,0.04079946217949267,0.9592005378205073
251,Passengers,303144152,100014699,203129453,2016.csv,2016,0.3299245535173642,0.6700754464826357
252,Battleship,303025485,65422625,237602860,2012.csv,2012,0.21589809517176417,0.7841019048282358
253,Wrath of the Titans,301970083,83670083,218300000,2012.csv,2012,0.27708070338875257,0.7229192966112474
254,Alice Through the Looking Glass,299457024,77041381,222415643,2016.csv,2016,0.257270241889534,0.7427297581104659
255,Ocean's Eight,297718711,140218711,157500000,2018.csv,2018,0.47097715333048046,0.5290228466695195
256,A Quiet Place Part II,297372261,160072261,137300000,2021.csv,2021,0.5382891479578857,0.4617108520421143
257,The Divergent Series: Insurgent,297002527,130179072,166823455,2015.csv,2015,0.4383096444159211,0.5616903555840789
258,Miss Peregrine's Home for Peculiar Children,296482446,87242834,209239612,2016.csv,2016,0.29425969455203427,0.7057403054479657
259,Ferdinand,296069199,84410380,211658819,2017.csv,2017,0.28510355107894897,0.7148964489210511
260,Pacific Rim: Uprising,290930148,59874525,231055623,2018.csv,2018,0.20580378283793402,0.794196217162066
261,Divergent,288885818,150947895,137937923,2014.csv,2014,0.5225174985917792,0.47748250140822074
262,Maze Runner: The Death Cure,288175335,58032443,230142892,2018.csv,2018,0.2013789382772818,0.7986210617227182
263,Pitch Perfect 2,287144079,184296230,102847849,2015.csv,2015,0.6418249355578737,0.35817506444212627
264,Oblivion,286168572,89107235,197061337,2013.csv,2013,0.3113802273158074,0.6886197726841926
265,Elysium,286140700,93050117,193090583,2013.csv,2013,0.3251900795657521,0.6748099204342479
266,John Carter,284139100,73078100,211061000,2012.csv,2012,0.2571912841280908,0.7428087158719092
267,Turbo,282570682,83028128,199542554,2013.csv,2013,0.29383136074959115,0.7061686392504088
268,Paddington,282370135,76271832,206098303,2014.csv,2014,0.2701129565277858,0.7298870434722142
269,Split,278454358,138291365,140162993,2017.csv,2017,0.4966392553281569,0.5033607446718431
270,The Bourne Legacy,276144750,113203870,162940880,2012.csv,2012,0.4099439514964525,0.5900560485035475
271,Mr. Peabody & Sherman,275698039,111506430,164191609,2014.csv,2014,0.4044512989807664,0.5955487010192336
272,Lincoln,275293450,182207973,93085477,2012.csv,2012,0.6618681737614898,0.33813182623851024
273,Tomb Raider,274650803,58250803,216400000,2018.csv,2018,0.21209041577060309,0.7879095842293969
274,Cloudy with a Chance of Meatballs 2,274325949,119793567,154532382,2013.csv,2013,0.43668332302023677,0.5633166769797632
275,Neighbors,270665134,150157400,120507734,2014.csv,2014,0.5547718606416444,0.44522813935835565
276,We're the Millers,269994119,150394119,119600000,2012.csv,2012,0.5570273884373015,0.4429726115626985
277,Epic,268426634,107518682,160907952,2013.csv,2013,0.4005514668861064,0.5994485331138936
278,Exodus: Gods and Kings,268175631,65014513,203161118,2014.csv,2014,0.24243259075243864,0.7575674092475614
279,Terminator: Dark Fate,261119292,62253077,198866215,2019.csv,2019,0.23840856998034446,0.7615914300196556
280,The Lone Ranger,260502115,89302115,171200000,2013.csv,2013,0.34280763900899613,0.6571923609910039
281,Mojin: The Lost Legend,259368448,1243810,258124638,2015.csv,2015,0.004795533186827721,0.9952044668131723
282,Blade Runner 2049,259239658,92054159,167185499,2017.csv,2017,0.35509288860425825,0.6449071113957418
283,Parasite,258632621,53369749,205262872,2019.csv,2019,0.2063535094438068,0.7936464905561932
284,Kung Fu Yoga,257743016,362657,257380359,2017.csv,2017,0.0014070487946800467,0.99859295120532
285,Annabelle,257047661,84273813,172773848,2014.csv,2014,0.3278528684997449,0.6721471315002551
286,Lost in Hong Kong,256283912,1302281,254981631,2015.csv,2015,0.005081399725161055,0.9949186002748389
287,Pegasus,255863112,0,255863112,2019.csv,2019,0.0,1.0
288,Halloween,255485178,159342015,96143163,2018.csv,2018,0.6236839892136522,0.37631601078634785
289,Get Out,255407969,176040665,79367304,2017.csv,2017,0.6892528282858708,0.31074717171412924
290,Us,255184580,175084580,80100000,2019.csv,2019,0.6861095603817441,0.3138904396182559
291,Baahubali 2: The Conclusion,254158390,20186659,233971731,2017.csv,2017,0.07942550706274147,0.9205744929372586
292,Men in Black: International,253890701,80001807,173888894,2019.csv,2019,0.31510333653377876,0.6848966634662212
293,X-Men: Dark Phoenix,252442974,65845974,186597000,2019.csv,2019,0.26083504308580996,0.73916495691419
294,Encanto,251689846,95959860,155729986,2021.csv,2021,0.38126234142953863,0.6187376585704614
295,American Hustle,251171807,150117807,101054000,2013.csv,2013,0.5976698133162692,0.4023301866837308
296,Journey to the West: The Demons Strike Back,247585244,880346,246704898,2017.csv,2017,0.0035557288704976295,0.9964442711295024
297,Glass,246999039,111048468,135950571,2019.csv,2019,0.44959068848846817,0.5504093115115318
298,Grown Ups 2,246984278,133668525,113315753,2013.csv,2013,0.5412025659382255,0.4587974340617746
299,The Peanuts Movie,246233113,130178411,116054702,2015.csv,2015,0.5286795484732388,0.47132045152676116
300,Teenage Mutant Ninja Turtles: Out of the Shadows,245623848,82051601,163572247,2016.csv,2016,0.3340538863311025,0.6659461136688974
301,Dark Shadows,245527149,79727149,165800000,2012.csv,2012,0.3247182616045446,0.6752817383954554
302,Dolittle,245438444,77047065,168391379,2020.csv,2020,0.3139160424273224,0.6860839575726776
303,The Bravest,245179562,290217,244889345,2019.csv,2019,0.0011836916488169597,0.9988163083511831
304,Pixels,244874809,78747585,166127224,2015.csv,2015,0.3215830379677805,0.6784169620322195
305,Hercules,244819862,72688614,172131248,2014.csv,2014,0.29690652304999665,0.7030934769500033
306,After Earth,243611982,60522097,183089885,2013.csv,2013,0.24843645416422908,0.7515635458357709
307,Daddy's Home,242786137,150357137,92429000,2015.csv,2015,0.6192986916711806,0.38070130832881943
308,RoboCop,242688965,58607007,184081958,2014.csv,2014,0.24149020125410317,0.7585097987458969
309,Alien: Covenant,240891763,74262031,166629732,2017.csv,2017,0.3082796608533269,0.6917203391466731
310,Sully,240797623,125070033,115727590,2016.csv,2016,0.5193989518742052,0.48060104812579485
311,Assassin's Creed,240697856,54647948,186049908,2016.csv,2016,0.2270396126835463,0.7729603873164537
312,Legend of Deification,240663149,214670,240448479,2020.csv,2020,0.0008919936471038197,0.9991080063528962
313,Resident Evil: Retribution,240159255,42345531,197813724,2012.csv,2012,0.17632271136084263,0.8236772886391573
314,Planes,239258712,90288712,148970000,2013.csv,2013,0.37736854489127236,0.6226314551087276
315,Crazy Rich Asians,238532921,174532921,64000000,2018.csv,2018,0.7316932198218459,0.2683067801781541
316,Silver Linings Playbook,236412453,132092958,104319495,2012.csv,2012,0.5587394247797937,0.44126057522020634
317,Hidden Figures,235956898,169607287,66349611,2016.csv,2016,0.7188062245164792,0.2811937754835207
318,Spy,235666219,110825712,124840507,2015.csv,2015,0.47026558354551445,0.5297344164544856
319,American Reunion,234989584,57011521,177978063,2012.csv,2012,0.24261297045404362,0.7573870295459564
320,Alvin and the Chipmunks: The Road Chip,234798636,85886987,148911649,2015.csv,2015,0.3657899741802589,0.6342100258197412
321,The Imitation Game,233555708,91125683,142430025,2014.csv,2014,0.39016679909188945,0.6098332009081106
322,Cruella,233503234,86103234,147400000,2021.csv,2021,0.3687453596467105,0.6312546403532895
323,Argo,232325503,136025503,96300000,2012.csv,2012,0.5854953556261105,0.4145046443738895
324,Annabelle Comes Home,231252591,74152591,157100000,2019.csv,2019,0.32065626023623667,0.6793437397637634
325,Ghostbusters,229147509,128350574,100796935,2016.csv,2016,0.5601220565744837,0.43987794342551634
326,Goodbye Mr. Loser,228122928,1293626,226829302,2015.csv,2015,0.005670740820931423,0.9943292591790686
327,Paddington 2,227978523,40891591,187086932,2017.csv,2017,0.17936597913655225,0.8206340208634477
328,Youth,227091290,1891956,225199334,2017.csv,2017,0.00833125744276674,0.9916687425572333
329,Baby Driver,226945087,107825862,119119225,2017.csv,2017,0.47511873213628986,0.5248812678637101
330,Hansel & Gretel: Witch Hunters,226349749,55703475,170646274,2013.csv,2013,0.2460947062945495,0.7539052937054505
331,Better Days,225918798,1921657,223997141,2019.csv,2019,0.008505963279779843,0.9914940367202202
332,Valerian and the City of a Thousand Planets,225874228,41189488,184684740,2017.csv,2017,0.18235585513545174,0.8176441448645483
333,Ford v Ferrari,225508210,117624357,107883853,2019.csv,2019,0.521596783549477,0.47840321645052303
334,Non-Stop,222809600,92168600,130641000,2014.csv,2014,0.4136652998793589,0.5863347001206412
335,"My Country, My Parents",221701823,166807,221535016,2021.csv,2021,0.000752393452353344,0.9992476065476467
336,Geostorm,221600160,33700160,187900000,2017.csv,2017,0.15207642449355632,0.8479235755064437
337,Jungle Cruise,220889446,116987516,103901930,2021.csv,2021,0.5296202155353317,0.4703797844646684
338,Inferno,220021259,34343574,185677685,2016.csv,2016,0.15609207108482184,0.8439079289151782
339,Captain Phillips,218791811,107100855,111690956,2013.csv,2013,0.4895103455220269,0.5104896544779731
340,Jack Reacher,218340595,80070736,138269859,2012.csv,2012,0.3667239983476275,0.6332760016523725
341,The Emoji Movie,217776646,86089513,131687133,2017.csv,2017,0.39531104267259215,0.6046889573274078
342,Too Cool to Kill,217255728,185882,217069846,2022.csv,2022,0.0008555907902230316,0.999144409209777
343,Dracula Untold,217124280,56280355,160843925,2014.csv,2014,0.2592080213230874,0.7407919786769126
344,Central Intelligence,216972543,127440871,89531672,2016.csv,2016,0.5873594383783389,0.412640561621661
345,Little Women,216601214,108101214,108500000,2019.csv,2019,0.4990794465260938,0.5009205534739062
346,A Little Red Flower,216000000,0,216000000,2020.csv,2020,0.0,1.0
347,The Croods 2: A New Age,215905815,58568815,157337000,2020.csv,2020,0.271270206409216,0.728729793590784
348,Ted 2,215863606,81476385,134387221,2015.csv,2015,0.37744382441197616,0.6225561755880239
349,The Expendables 3,214657577,39322544,175335033,2014.csv,2014,0.18318730952599918,0.8168126904740008
350,Creed II,214215889,115715889,98500000,2018.csv,2018,0.5401835015142131,0.45981649848578693
351,Smallfoot,214040103,83240103,130800000,2018.csv,2018,0.3888995652370808,0.6111004347629192
352,Into the Woods,212902372,128002372,84900000,2014.csv,2014,0.6012256735213829,0.39877432647861716
353,Bridget Jones's Baby,211952420,24252420,187700000,2016.csv,2016,0.11442388815376583,0.8855761118462342
354,Fury,211817906,85817906,126000000,2014.csv,2014,0.4051494400100433,0.5948505599899566
355,Nice View,211000000,0,211000000,2022.csv,2022,0.0,1.0
356,Us and Them,209221380,0,209221380,2018.csv,2018,0.0,1.0
357,Tomorrowland,209035668,93436322,115599346,2015.csv,2015,0.44698745861878464,0.5530125413812154
358,Me Before You,208314186,56245075,152069111,2016.csv,2016,0.2700011750519957,0.7299988249480043
359,Safe House,208076205,126373434,81702771,2012.csv,2012,0.6073420745058283,0.3926579254941717
360,Raging Fire,205846481,385305,205461176,2021.csv,2021,0.0018718075632296089,0.9981281924367704
361,London Has Fallen,205754447,62524260,143230187,2016.csv,2016,0.30387804935268303,0.696121950647317
362,Journey to the West,205637183,18058,205619125,2013.csv,2013,8.781485788005567e-05,0.99991218514212
363,White House Down,205366737,73103784,132262953,2013.csv,2013,0.35596701329485503,0.644032986705145
364,A Dog's Purpose,205035819,64508620,140527199,2017.csv,2017,0.3146212223533489,0.6853787776466511
365,Everest,203427584,43482270,159945314,2015.csv,2015,0.2137481512831613,0.7862518487168387
366,Arrival,203388186,100546139,102842047,2016.csv,2016,0.49435584719753584,0.5056441528024641
367,Need for Speed,203277636,43577636,159700000,2014.csv,2014,0.2143749644943726,0.7856250355056273
368,The Addams Family,203044905,100044905,103000000,2019.csv,2019,0.49272305059809307,0.5072769494019069
369,The Conjuring: The Devil Made Me Do It,202031050,65631050,136400000,2021.csv,2021,0.324856253531326,0.675143746468674
370,Birds of Prey,201858461,84158461,117700000,2020.csv,2020,0.41691817416561006,0.5830818258343899
371,Straight Outta Compton,201634991,161197785,40437206,2015.csv,2015,0.7994534291917617,0.20054657080823834
372,21 Jump Street,201585328,138447667,63137661,2012.csv,2012,0.6867943633278708,0.31320563667212925
373,Percy Jackson: Sea of Monsters,199850315,68559554,131290761,2013.csv,2013,0.34305452057956476,0.6569454794204352
374,Shock Wave 2,198921659,0,198921659,2020.csv,2020,0.0,1.0
375,Total Recall,198467168,58877969,139589199,2012.csv,2012,0.296663521696445,0.703336478303555
376,The Island,198326350,670883,197655467,2018.csv,2018,0.0033827224672868736,0.9966172775327131
377,The Impossible,198087212,19019882,179067330,2012.csv,2012,0.09601771769093302,0.903982282309067
378,Lost in Thailand,197757387,57387,197700000,2012.csv,2012,0.00029018890707733716,0.9997098110929227
379,Christopher Robin,197744377,99215042,98529335,2018.csv,2018,0.5017338217409844,0.4982661782590157
380,Jack the Giant Slayer,197687603,65187603,132500000,2013.csv,2013,0.3297505863329225,0.6702494136670776
381,Ghostbusters: Afterlife,197360575,129360575,68000000,2021.csv,2021,0.655452969773725,0.3445470302262749
382,Smurfs: The Lost Village,197183546,45020282,152163264,2017.csv,2017,0.22831662637814618,0.7716833736218538
383,Chinese Doctors,197143218,0,197143218,2021.csv,2021,0.0,1.0
384,The Other Woman,196710396,83911193,112799203,2014.csv,2014,0.4265722336301941,0.5734277663698059
385,The Vow,196114570,125014030,71100540,2012.csv,2012,0.6374540657535032,0.36254593424649684
386,The Shape of Water,195333312,63859435,131473877,2017.csv,2017,0.3269254708587545,0.6730745291412455
387,Rocketman,195320400,96368160,98952240,2019.csv,2019,0.4933850227625993,0.5066149772374007
388,The BFG,195243411,55483770,139759641,2016.csv,2016,0.28417742609506036,0.7158225739049396
389,The Intern,194564672,75764672,118800000,2015.csv,2015,0.38940610965591943,0.6105938903440805
390,Weathering with You,193932489,8056636,185875853,2019.csv,2019,0.04154350847319863,0.9584564915268013
391,Downton Abbey,193795496,96854135,96941361,2019.csv,2019,0.49977495349014717,0.5002250465098529
392,The Monkey King 2,193678298,709982,192968316,2016.csv,2016,0.003665779838689,0.996334220161311
393,The Equalizer,192330738,101530738,90800000,2014.csv,2014,0.527896575741315,0.47210342425868507
394,The Lego Movie 2: The Second Part,192306508,105806508,86500000,2019.csv,2019,0.5501972299346208,0.44980277006537916
395,Sheep Without a Shepherd,191602146,0,191602146,2019.csv,2019,0.0,1.0
396,The Equalizer 2,190400157,102084362,88315795,2018.csv,2018,0.5361569213411941,0.4638430786588059
397,The White Storm 2: Drug Lords,189396380,609461,188786919,2019.csv,2019,0.003217912612690908,0.9967820873873091
398,Breakup Buddies,189017596,777896,188239700,2014.csv,2014,0.004115468699538428,0.9958845313004616
399,The Secret Life of Walter Mitty,188133322,58236838,129896484,2013.csv,2013,0.30955089391341317,0.6904491060865868
400,Project Gutenberg,188116796,0,188116796,2018.csv,2018,0.0,1.0
401,12 Years a Slave,187733202,56671993,131061209,2013.csv,2013,0.30187517389704993,0.6981248261029501
402,Jian Bing Man,186683536,0,186683536,2015.csv,2015,0.0,1.0
403,Pitch Perfect 3,185400345,104897530,80502815,2017.csv,2017,0.5657892923554161,0.4342107076445839
404,Bad Moms,183936074,113257297,70678777,2016.csv,2016,0.615742711785835,0.3842572882141651
405,Jupiter Ascending,183887723,47387723,136500000,2015.csv,2015,0.25769922117095334,0.7423007788290467
406,Stand by Me Doraemon,183442714,0,183442714,2014.csv,2014,0.0,1.0
407,Storks,183388953,72679278,110709675,2016.csv,2016,0.3963121922616571,0.6036878077383429
408,Mirror Mirror,183018522,64935167,118083355,2012.csv,2012,0.3548010676209045,0.6451989323790955
409,From Vegas to Macau III,181732879,0,181732879,2016.csv,2016,0.0,1.0
410,Cliff Walkers,181325565,152972,181172593,2021.csv,2021,0.0008436317294806168,0.9991563682705193
411,Daddy's Home 2,180613180,104029443,76583737,2017.csv,2017,0.5759792447040687,0.42402075529593136
412,Hacksaw Ridge,180563636,67209615,113354021,2016.csv,2016,0.37222120959061766,0.6277787904093823
413,The Post,179769457,81903458,97865999,2017.csv,2017,0.4556027445752367,0.5443972554247632
414,The Dictator,179379533,59650222,119729311,2012.csv,2012,0.3325363880839181,0.6674636119160818
415,Allegiant,179246868,66184051,113062817,2016.csv,2016,0.36923407219589466,0.6307659278041053
416,Abominable,179053956,60716390,118337566,2019.csv,2019,0.33909549588505045,0.6609045041149496
417,Baywatch,177856751,58060186,119796565,2017.csv,2017,0.32644353207599075,0.6735564679240093
418,Lee Daniels' The Butler,177313795,116632095,60681700,2013.csv,2013,0.6577722562421046,0.34222774375789544
419,The Hitman's Bodyguard,176586701,75468583,101118118,2017.csv,2017,0.4273741033306919,0.5726258966693081
420,Looper,176506819,66486205,110020614,2012.csv,2012,0.37667782682095696,0.623322173179043
421,Serial (Bad) Weddings,176404493,0,176404493,2014.csv,2014,0.0,1.0
422,Ip Man 4: The Finale,176345966,3956031,172389935,2019.csv,2019,0.02243335126815433,0.9775666487318456
423,The Monkey King Havoc in Heavens Palace,175835580,0,175835580,2014.csv,2014,0.0,1.0
424,The Mule,174804407,103804407,71000000,2018.csv,2018,0.5938317504775494,0.40616824952245056
425,Identity Thief,173965010,134506920,39458090,2013.csv,2013,0.7731837568945618,0.22681624310543827
426,The Nutcracker and the Four Realms,173961069,54858851,119102218,2018.csv,2018,0.3153513100106323,0.6846486899893677
427,Operation Mekong,173839072,800012,173039060,2016.csv,2016,0.004602026407504062,0.9953979735924959
428,Creed,173567581,109767581,63800000,2015.csv,2015,0.6324198353608442,0.3675801646391557
429,Gemini Man,173469516,48546770,124922746,2019.csv,2019,0.27985764369112553,0.7201423563088745
430,The Girl on the Train,173185859,75395035,97790824,2016.csv,2016,0.435341750390833,0.564658249609167
431,The Grand Budapest Hotel,172936941,59301324,113635617,2014.csv,2014,0.342907210322403,0.657092789677597
432,Spies in Disguise,171616764,66757013,104859751,2019.csv,2019,0.3889888810629246,0.6110111189370754
433,John Wick: Chapter 2,171539887,92029184,79510703,2017.csv,2017,0.5364885427492441,0.46351145725075593
434,Anchorman 2: The Legend Continues,171464676,125168368,46296308,2013.csv,2013,0.7299950690718361,0.2700049309281639
435,Chinese Zodiac,170525083,0,170525083,2012.csv,2012,0.0,1.0
436,Olympus Has Fallen,170270201,98925640,71344561,2013.csv,2013,0.5809920903305916,0.4190079096694083
437,Dumb and Dumber To,169837010,86208010,83629000,2014.csv,2014,0.5075926030492411,0.49240739695075886
438,Ghost in the Shell,169801921,40563557,129238364,2017.csv,2017,0.23888750351652382,0.7611124964834762
439,Insidious: The Last Key,167885588,67745330,100140258,2018.csv,2018,0.40352081919026905,0.596479180809731
440,Fantastic Four,167882881,56117548,111765333,2015.csv,2015,0.3342660530110869,0.6657339469889131
441,Magic Mike,167739368,113721571,54017797,2012.csv,2012,0.6779658964733908,0.3220341035266092
442,The Suicide Squad,167417425,55817425,111600000,2021.csv,2021,0.33340272077413685,0.6665972792258631
443,Wonder Woman 1984,166801036,46801036,120000000,2020.csv,2020,0.28058000790834414,0.7194199920916559
444,Bridge of Spies,165478348,72313754,93164594,2015.csv,2015,0.4369982833041094,0.5630017166958906
445,The Huntsman: Winter's War,164989338,48390190,116599148,2016.csv,2016,0.2932928308373478,0.7067071691626522
446,From Vegas to Macau II,163877532,0,163877532,2015.csv,2015,0.0,1.0
447,Space Jam: A New Legacy,162892228,70592228,92300000,2021.csv,2021,0.43336768651724744,0.5666323134827526
448,The Magnificent Seven,162360636,93432655,68927981,2016.csv,2016,0.5754637164638847,0.4245362835361152
449,Jack Reacher: Never Go Back,162146076,58697076,103449000,2016.csv,2016,0.36200121179620776,0.6379987882037922
450,Insidious: Chapter 2,161919318,83586447,78332871,2013.csv,2013,0.5162228203060983,0.4837771796939016
451,Flight,161772375,93772375,68000000,2012.csv,2012,0.5796562917494411,0.42034370825055883
452,Into the Storm,161502194,47602194,113900000,2014.csv,2014,0.29474642307336085,0.7052535769266391
453,Unbroken,161459297,115637895,45821402,2014.csv,2014,0.7162046233856698,0.28379537661433024
454,The Sacrifice,161047608,0,161047608,2020.csv,2020,0.0,1.0
455,The Predator,160542134,51024708,109517426,2018.csv,2018,0.3178275181018835,0.6821724818981165
456,"Three Billboards Outside Ebbing, Missouri",160192031,54513740,105678291,2017.csv,2017,0.3403024461310438,0.6596975538689562
457,Underworld: Awakening,160112671,62321039,97791632,2012.csv,2012,0.3892323987275186,0.6107676012724814
458,Johnny English Strikes Again,158970776,4412170,154558606,2018.csv,2018,0.02775459811556811,0.9722454018844319
459,Focus,158762963,53862963,104900000,2015.csv,2015,0.3392665517334795,0.6607334482665205
460,Goosebumps,158260952,80080379,78180573,2015.csv,2015,0.5060021312142745,0.4939978687857255
461,Don't Breathe,157761002,89217875,68543127,2016.csv,2016,0.5655255346311758,0.43447446536882417
462,Hustlers,157563598,104963598,52600000,2019.csv,2019,0.6661665469203109,0.33383345307968915
463,Ip Man 3,156954938,2679437,154275501,2015.csv,2015,0.01707137751855886,0.9829286224814411
464,The Climbers,156892866,487157,156405709,2019.csv,2019,0.0031050296448788183,0.9968949703551212
465,The Matrix Resurrections,156575035,37686805,118888230,2021.csv,2021,0.24069485279054864,0.7593051472094514
466,This Means War,156491279,54760791,101730488,2012.csv,2012,0.3499287075288074,0.6500712924711926
467,The Hateful Eight,155760117,54117416,101642701,2015.csv,2015,0.3474407765114866,0.6525592234885135
468,Escape Room,155712077,57005601,98706476,2019.csv,2019,0.36609620845273294,0.6339037915472671
469,The Monuments Men,155641650,78031620,77610030,2014.csv,2014,0.5013543611237737,0.49864563887622626
470,The Accountant,155160045,86260045,68900000,2016.csv,2016,0.5559423819450426,0.44405761805495736
471,Lone Survivor,154802912,125095601,29707311,2013.csv,2013,0.8080959161801814,0.19190408381981858
472,Yesterday,154608507,73286650,81321857,2019.csv,2019,0.47401434385496005,0.5259856561450399
473,Ride Along,154468902,134938200,19530702,2014.csv,2014,0.8735622397315933,0.12643776026840664
474,House of Gucci,154075986,53809574,100266412,2021.csv,2021,0.3492404974776537,0.6507595025223464
475,Peter Rabbit 2: The Runaway,153901717,40501717,113400000,2021.csv,2021,0.2631661152942173,0.7368338847057827
476,Monkey King: Hero Is Back,153262397,0,153262397,2015.csv,2015,0.0,1.0
477,Duckweed,152894264,471575,152422689,2017.csv,2017,0.0030843210704098096,0.9969156789295902
478,Jackass Presents: Bad Grandpa,151826547,102003019,49823528,2013.csv,2013,0.6718391547164674,0.3281608452835327
479,47 Ronin,151783839,38362475,113421364,2013.csv,2013,0.25274413437388416,0.7472558656261158
480,Red Sparrow,151572634,46874505,104698129,2018.csv,2018,0.30925440670246584,0.6907455932975342
481,Darkest Hour,150847207,56468410,94378797,2017.csv,2017,0.37434176689794463,0.6256582331020554
482,Gods of Egypt,150680864,31153464,119527400,2015.csv,2015,0.20675129656808977,0.7932487034319102
483,A Writer's Odyssey,150123320,160013,149963307,2021.csv,2021,0.001065877040289277,0.9989341229597107
484,Lights Out,148868835,67268835,81600000,2016.csv,2016,0.4518664702387172,0.5481335297612828
485,King Arthur: Legend of the Sword,148675066,39175066,109500000,2017.csv,2017,0.2634945257061463,0.7365054742938537
486,RED 2,148075565,53262560,94813005,2013.csv,2013,0.35969850933879605,0.640301490661204
487,The Angry Birds Movie 2,147792047,41667116,106124931,2019.csv,2019,0.2819307049722371,0.7180692950277628
488,Planes: Fire & Rescue,146965787,59165787,87800000,2014.csv,2014,0.402582044486313,0.597417955513687
489,The Last Witch Hunter,146936910,27367660,119569250,2015.csv,2015,0.18625449521158435,0.8137455047884157
490,The Boss Baby 2: Family Business,146745280,57300280,89445000,2021.csv,2021,0.3904744329766518,0.6095255670233483
491,Angel Has Fallen,146661977,69030436,77631541,2019.csv,2019,0.470677113537069,0.529322886462931
492,Mama,146428180,71628180,74800000,2013.csv,2013,0.4891693661698179,0.5108306338301821
493,Time Raiders,145819137,0,145819137,2016.csv,2016,0.0,1.0
494,The Foreigner,145374099,34393507,110980592,2017.csv,2017,0.23658620921186244,0.7634137907881375
495,PAW Patrol: The Movie,144327371,40127371,104200000,2021.csv,2021,0.27803022200134164,0.7219697779986584
496,Pete's Dragon,143695338,76233151,67462187,2016.csv,2016,0.5305193060612725,0.4694806939387275
497,The Invisible Man,143151000,70410000,72741000,2020.csv,2020,0.49185824758471824,0.5081417524152818
498,More Than Blue,142958164,722669,142235495,2018.csv,2018,0.005055108290282743,0.9949448917097172
499,Paranormal Activity 4,142802657,53885000,88917657,2012.csv,2012,0.3773389174404507,0.6226610825595493
500,Power Rangers,142337240,85364450,56972790,2017.csv,2017,0.5997337731151735,0.4002662268848265
501,Onward,141940042,61555145,80384897,2020.csv,2020,0.43367004921697855,0.5663299507830215
502,The Taking of Tiger Mountain,141654055,228984,141425071,2014.csv,2014,0.0016165015537324364,0.9983834984462676
503,Jujutsu Kaisen 0: The Movie,141316689,24445224,116871465,2021.csv,2021,0.17298186203612512,0.8270181379638749
504,Trainwreck,140795793,110212700,30583093,2015.csv,2015,0.7827840424180856,0.2172159575819144
505,Sausage Party,140705322,97685686,43019636,2016.csv,2016,0.6942572221966131,0.3057427778033869
506,Girls Trip,140552359,115171585,25380774,2017.csv,2017,0.8194212165446473,0.18057878345535275
507,Step Up Revolution,140470746,35074677,105396069,2012.csv,2012,0.24969381881121355,0.7503061811887864
508,Lion,140312928,51738905,88574023,2016.csv,2016,0.3687394008341127,0.6312605991658873
509,Scream,139917102,81517102,58400000,2022.csv,2022,0.5826099943093447,0.4173900056906553
510,Mr. Six,139191345,1415450,137775895,2015.csv,2015,0.010169094924688026,0.989830905075312
511,The Admiral: Roaring Currents,138342258,2589811,135752447,2014.csv,2014,0.018720317547513212,0.9812796824524868
512,Let's Be Cops,138224951,82390774,55834177,2014.csv,2014,0.5960629640592168,0.40393703594078323
513,Escape Plan,137328301,25135965,112192336,2013.csv,2013,0.18303557836923942,0.8169644216307606
514,The First Purge,137056262,69488745,67567517,2018.csv,2018,0.5070089026650968,0.49299109733490326
515,Annie,136853506,85911262,50942244,2014.csv,2014,0.6277607677804031,0.3722392322195969
516,The Best Exotic Marigold Hotel,136836156,46412041,90424115,2012.csv,2012,0.3391796609662142,0.6608203390337858
517,How Long Will I Love U,136796719,746933,136049786,2018.csv,2018,0.005460167505918033,0.994539832494082
518,Skiptrace,136579287,0,136579287,2016.csv,2016,0.0,1.0
519,The Wind Rises,136454220,5209580,131244640,2012.csv,2012,0.03817822563494189,0.9618217743650581
520,Jack Ryan: Shadow Recruit,135503748,50577412,84926336,2014.csv,2014,0.3732547087922616,0.6267452912077384
521,American Made,134866593,51342000,83524593,2017.csv,2017,0.3806873063072039,0.6193126936927961
522,Last Vegas,134402450,63914167,70488283,2012.csv,2012,0.4755431690419334,0.5244568309580666
523,Point Break,133718711,28782481,104936230,2015.csv,2015,0.21524647362178057,0.7847535263782194
524,The Big Short,133440870,70259870,63181000,2015.csv,2015,0.5265243699325401,0.47347563006745985
525,Tom & Jerry: The Movie,133336687,46536687,86800000,2021.csv,2021,0.34901637386565637,0.6509836261343437
526,Zero Dark Thirty,132820716,95720716,37100000,2012.csv,2012,0.7206761029657452,0.2793238970342548
527,A Wrinkle in Time,132675864,100478608,32197256,2018.csv,2018,0.7573239394921144,0.2426760605078856
528,Ghost Rider: Spirit of Vengeance,132563930,51774002,80789928,2012.csv,2012,0.39055874399619867,0.6094412560038014
529,Be Somebody,132326332,0,132326332,2021.csv,2021,0.0,1.0
530,2 Guns,131940411,75612460,56327951,2013.csv,2013,0.5730803733815867,0.4269196266184134
531,Death on the Nile,131874141,44474644,87399497,2022.csv,2022,0.33725068207268927,0.6627493179273107
532,Halloween Kills,131647155,92002155,39645000,2021.csv,2021,0.6988541074055113,0.30114589259448865
533,The House with a Clock in Its Walls,131457147,68549695,62907452,2018.csv,2018,0.521460388912898,0.478539611087102
534,A Bad Moms Christmas,130560428,72110659,58449769,2017.csv,2017,0.5523163496369665,0.4476836503630334
535,Cloud Atlas,130482868,27108272,103374596,2012.csv,2012,0.2077534960375028,0.7922465039624972
536,Raya and the Last Dragon,130423032,54723032,75700000,2021.csv,2021,0.4195810445504748,0.5804189554495252
537,Warm Hug,129240236,0,129240236,2020.csv,2020,0.0,1.0
538,The Woman in Black,128955898,54333290,74622608,2012.csv,2012,0.4213323379749564,0.5786676620250436
539,Pan,128388320,35088320,93300000,2015.csv,2015,0.2732983810365304,0.7267016189634695
540,Sister,128317206,0,128317206,2021.csv,2021,0.0,1.0
541,Blended,127994610,46294610,81700000,2014.csv,2014,0.36169187124364066,0.6383081287563593
542,Ad Astra,127461872,50188370,77273502,2019.csv,2019,0.393752023350167,0.606247976649833
543,Midway,127420861,56846802,70574059,2019.csv,2019,0.4461341852022174,0.5538658147977826
544,Chronicle,126636097,64575175,62060922,2012.csv,2012,0.5099270786906833,0.49007292130931673
545,Walking with Dinosaurs 3D,126546518,36076121,90470397,2012.csv,2012,0.2850818937586256,0.7149181062413744
546,Sex Tape,126069509,38543473,87526036,2014.csv,2014,0.30573191968249835,0.6942680803175016
547,This Is the End,126041322,101470202,24571120,2013.csv,2013,0.8050550437736602,0.1949449562263398
548,The King's Man,125928656,37176373,88752283,2021.csv,2021,0.2952177382088474,0.7047822617911526
549,The Upside,125852517,108252517,17600000,2019.csv,2019,0.860153770305603,0.13984622969439697
550,Detective Chinatown,125842935,474252,125368683,2015.csv,2015,0.003768602504383738,0.9962313974956163
551,Wolf Totem,125837070,210591,125626479,2015.csv,2015,0.0016735211651065938,0.9983264788348934
552,Mechanic: Resurrection,125729635,21218403,104511232,2016.csv,2016,0.1687621458536804,0.8312378541463196
553,Ender's Game,125544024,61737191,63806833,2013.csv,2013,0.49175730578780874,0.5082426942121913
554,Happy Death Day,125479266,55683845,69795421,2017.csv,2017,0.44376929173302626,0.5562307082669737
555,Captain Underpants: The First Epic Movie,125427681,73921000,51506681,2017.csv,2017,0.5893515642691345,0.4106484357308655
556,Ride Along 2,124605297,91221830,33383467,2015.csv,2015,0.7320862932496361,0.2679137067503639
557,The Theory of Everything,123726688,35893537,87833151,2014.csv,2014,0.2901034334645731,0.7098965665354269
558,The Curse of La Llorona,123133739,54733739,68400000,2019.csv,2019,0.4445064321485438,0.5554935678514562
559,The Lego Ninjago Movie,123081555,59281555,63800000,2017.csv,2017,0.4816445079849698,0.5183554920150302
560,The Pirates! Band of Misfits,123054041,31051126,92002915,2012.csv,2012,0.25233731251458863,0.7476626874854114
561,Looking Up,122994583,84267,122910316,2019.csv,2019,0.0006851277344466463,0.9993148722655534
562,Zombieland: Double Tap,122810399,73123082,49687317,2019.csv,2019,0.5954144160056023,0.40458558399439776
563,Dragon Blade,122593849,74068,122519781,2015.csv,2015,0.0006041738684621934,0.9993958261315378
564,Prisoners,122126687,61002302,61124385,2013.csv,2013,0.4995001788593512,0.5004998211406488
565,Secret Superstar,122026260,0,122026260,2017.csv,2017,0.0,1.0
566,Deepwater Horizon,121790373,61433527,60356846,2016.csv,2016,0.5044202221139433,0.4955797778860567
567,Last Christmas,121550750,35150750,86400000,2019.csv,2019,0.2891857927655732,0.7108142072344268
568,Soul,120957731,0,120957731,2020.csv,2020,0.0,1.0
569,The Nut Job,120885527,64251541,56633986,2014.csv,2014,0.531507307735855,0.4684926922641451
570,Instant Family,120556201,67363237,53192964,2018.csv,2018,0.5587704028596588,0.4412295971403412
571,The Commuter,119942387,36343858,83598529,2017.csv,2017,0.3030109614210029,0.6969890385789971
572,Extreme Job,119932733,1565885,118366848,2019.csv,2019,0.013056360518358236,0.9869436394816418
573,The Addams Family 2,119815153,56489153,63326000,2021.csv,2021,0.4714691888763018,0.5285308111236982
574,Parental Guidance,119772232,77267296,42504936,2012.csv,2012,0.6451186114658028,0.35488138853419715
575,Dora and the Lost City of Gold,119682635,60477943,59204692,2019.csv,2019,0.505319280445321,0.4946807195546789
576,Wonder Park,119559110,45216793,74342317,2019.csv,2019,0.37819613244026323,0.6218038675597368
577,Allied,119520023,40098064,79421959,2016.csv,2016,0.33549243878575896,0.664507561214241
578,I Belonged to You,119107580,744541,118363039,2016.csv,2016,0.006250995948368693,0.9937490040516314
579,The Shallows,119100758,55124043,63976715,2016.csv,2016,0.46283536667331704,0.537164633326683
580,Forever Young,119055731,0,119055731,2017.csv,2017,0.0,1.0
581,The Purge: Election Year,118587880,79213375,39374505,2016.csv,2016,0.6679719293405025,0.3320280706594974
582,Jurassic Park 2013 Re-release,118192315,45385935,72806380,2013.csv,2013,0.38400072796611184,0.6159992720338882
583,A Cool Fish,118153135,551876,117601259,2018.csv,2018,0.004670853634141828,0.9953291463658581
584,Why Him?,118102725,60323786,57778939,2016.csv,2016,0.5107738707976467,0.4892261292023533
585,P Storm,117991727,326711,117665016,2019.csv,2019,0.0027689314183866466,0.9972310685816134
586,Saving Mr. Banks,117867984,83301580,34566404,2013.csv,2013,0.7067362753909493,0.29326372460905076
587,Pompeii,117831631,23219748,94611883,2014.csv,2014,0.19705869979852864,0.8029413002014714
588,Magic Mike XXL,117813057,66013057,51800000,2015.csv,2015,0.5603203811271954,0.43967961887280455
589,Game Night,117679066,69179066,48500000,2018.csv,2018,0.5878621266419637,0.41213787335803637
590,Warm Bodies,116980662,66380662,50600000,2013.csv,2013,0.5674498747493838,0.4325501252506162
591,Abraham Lincoln: Vampire Hunter,116471580,37519139,78952441,2012.csv,2012,0.32213127872052566,0.6778687212794744
592,Personal Tailor,116126458,375892,115750566,2013.csv,2013,0.0032369195312923434,0.9967630804687077
593,Dragon Ball Super: Broly,115757940,30712119,85045821,2018.csv,2018,0.26531328218176653,0.7346867178182335
594,Detective Conan: The Fist of Blue Sapphire,115570314,0,115570314,2019.csv,2019,0.0,1.0
595,Pitch Perfect,115350426,65001093,50349333,2012.csv,2012,0.5635097784554346,0.4364902215445654
596,The Gentlemen,115171795,36471795,78700000,2019.csv,2019,0.31667297535824634,0.6833270246417537
597,The Monkey King 3,115084576,187074,114897502,2018.csv,2018,0.0016255349457081026,0.998374465054292
598,So Young,114926694,11186,114915508,2013.csv,2013,9.733160861653256e-05,0.9999026683913834
599,Book of Love,114679097,0,114679097,2016.csv,2016,0.0,1.0
600,Office Christmas Party,114501299,54767494,59733805,2016.csv,2016,0.47831329843690246,0.5216867015630976
601,Hope Springs,114281051,63536011,50745040,2012.csv,2012,0.5559627816163504,0.4440372183836496
602,Seventh Son,114178613,17223265,96955348,2014.csv,2014,0.15084493100297164,0.8491550689970284
603,My Love,114016434,86252,113930182,2021.csv,2021,0.0007564874375916721,0.9992435125624083
604,The Dark Tower,113231078,50701325,62529753,2017.csv,2017,0.44776863291895885,0.5522313670810411
605,Pet Sematary,113118226,54724696,58393530,2019.csv,2019,0.4837831880425706,0.5162168119574294
606,Insidious: Chapter 3,112983889,52218558,60765331,2015.csv,2015,0.46217702773534375,0.5378229722646563
607,Boonie Bears: Blast Into the Past,112367881,0,112367881,2019.csv,2019,0.0,1.0
608,How to Be Single,112343513,46843513,65500000,2016.csv,2016,0.4169667811616324,0.5830332188383677
609,The Purge: Anarchy,111928365,71962800,39965565,2014.csv,2014,0.6429362208587609,0.35706377914123916
610,"Dad, Where Are We Going?",111870000,0,111870000,2014.csv,2014,0.0,1.0
611,Get Hard,111711453,90411453,21300000,2015.csv,2015,0.809330203591569,0.19066979640843093
612,The Call of the Wild,111105497,62342368,48763129,2020.csv,2020,0.5611096631879519,0.4388903368120481
613,Good Boys,111037232,83140306,27896926,2019.csv,2019,0.748760613917321,0.251239386082679
614,Free Birds,110387072,55750480,54636592,2013.csv,2013,0.5050453734292364,0.49495462657076367
615,10 Cloverfield Lane,110216998,72082998,38134000,2016.csv,2016,0.6540098107190326,0.34599018928096736
616,Buddies in India,110155128,293194,109861934,2017.csv,2017,0.002661646401064506,0.9973383535989355
617,The 5th Wave,109906372,34916787,74989585,2015.csv,2015,0.3176957474312772,0.6823042525687227
618,Along With the Gods: The Two Worlds,109383972,1908823,107475149,2017.csv,2017,0.017450664526974757,0.9825493354730253
619,The Boxtrolls,108255770,50837305,57418465,2014.csv,2014,0.4696036525351027,0.5303963474648973
620,Neighbors 2: Sorority Rising,108007109,55455765,52551344,2016.csv,2016,0.5134455084803723,0.48655449151962765
621,Horrible Bosses 2,107645357,54445357,53200000,2014.csv,2014,0.5057845365313806,0.49421546346861944
622,Paul Blart: Mall Cop 2,107588225,71038190,36550035,2015.csv,2015,0.6602784830774929,0.33972151692250707
623,Clifford the Big Red Dog,107347356,48947356,58400000,2021.csv,2021,0.4559716962195138,0.5440283037804862
624,Vacation,107228221,58884188,48344033,2015.csv,2015,0.5491482321617552,0.45085176783824477
625,ParaNorman,107139399,56003051,51136348,2012.csv,2012,0.5227120137196215,0.4772879862803785
626,The Man from U.N.C.L.E.,107045109,45445109,61600000,2015.csv,2015,0.42454166682197503,0.575458333178025
627,The Breakup Guru,106980263,208959,106771304,2014.csv,2014,0.00195324814260365,0.9980467518573963
628,Chronicles of the Ghostly Tribe,106380000,0,106380000,2015.csv,2015,0.0,1.0
629,Shaun the Sheep Movie,106209378,19375982,86833396,2015.csv,2015,0.18243193176406702,0.817568068235933
630,First Man,105697415,44936545,60760870,2018.csv,2018,0.4251432733714443,0.5748567266285557
631,Gangster Squad,105200903,46000903,59200000,2013.csv,2013,0.4372671877160598,0.5627328122839402
632,Sisters,105011053,87044645,17966408,2015.csv,2015,0.8289093625220576,0.17109063747794245
633,The Campaign,104907746,86907746,18000000,2012.csv,2012,0.8284206773444546,0.17157932265554537
634,Scary Stories to Tell in the Dark,104545505,68947075,35598430,2019.csv,2019,0.6594934425922951,0.3405065574077049
635,Book Club,104438188,68566296,35871892,2018.csv,2018,0.6565251400187065,0.34347485998129346
636,Wrath of Man,103966489,27466489,76500000,2021.csv,2021,0.26418598208120697,0.7358140179187931
637,Immortal Demon Slayer,103818506,0,103818506,2017.csv,2017,0.0,1.0
638,Ouija,103590271,50856010,52734261,2014.csv,2014,0.49093423068658637,0.5090657693134136
639,Birdman or (The Unexpected Virtue of Ignorance),103215094,42340598,60874496,2014.csv,2014,0.41021711417518064,0.5897828858248194
640,Cold War 2,103197501,560824,102636677,2016.csv,2016,0.00543447268165922,0.9945655273183408
641,Night School,103105878,77339130,25766748,2018.csv,2018,0.75009428657404,0.24990571342596005
642,Transcendence,103039258,23022309,80016949,2014.csv,2014,0.22343240282262125,0.7765675971773788
643,Jigsaw,102952888,38052832,64900056,2017.csv,2017,0.3696140316141496,0.6303859683858505
644,Chappie,102811889,31569268,71242621,2015.csv,2015,0.3070585348354022,0.6929414651645979
645,Star Wars: Episode I - The Phantom Menace 2012 3D Release,102739593,43456382,59283211,2012.csv,2012,0.4229759991359903,0.5770240008640096
646,Project X,102731865,54731865,48000000,2012.csv,2012,0.5327642499238187,0.46723575007618134
647,Railroad Tigers,102205175,218044,101987131,2016.csv,2016,0.002133394908819441,0.9978666050911805
648,Heaven Is for Real,101888019,91443253,10444766,2014.csv,2014,0.8974877900020806,0.10251220999791938
649,Detective Conan: Zero the Enforcer,101860359,0,101860359,2018.csv,2018,0.0,1.0
650,The Devil Inside,101758490,53261944,48496546,2012.csv,2012,0.5234152354265477,0.4765847645734523
651,Joy,101134059,56451232,44682827,2015.csv,2015,0.5581822044737669,0.4418177955262332
652,"Alexander and the Terrible, Horrible, No Good, Very Bad Day",100654149,66954149,33700000,2014.csv,2014,0.665190155251325,0.334809844748675
653,Life,100541806,30234022,70307784,2017.csv,2017,0.30071095003008,0.69928904996992
654,Instructions Not Included,100486616,44467206,56019410,2013.csv,2013,0.44251869323572407,0.557481306764276
655,Tammy,100375432,84525432,15850000,2014.csv,2014,0.8420928340313395,0.15790716596866053
656,PK,100370104,10616104,89754000,2014.csv,2014,0.10576958254422054,0.8942304174557795
657,Philomena,100129872,37709979,62419893,2013.csv,2013,0.376610678180034,0.623389321819966
658,The Continent,100125957,0,100125957,2014.csv,2014,0.0,1.0
659,Atomic Blonde,100014025,51687870,48326155,2017.csv,2017,0.5168062179279356,0.48319378207206437
660,The Book of Life,99783556,50151543,49632013,2014.csv,2014,0.5026032846534353,0.4973967153465647
661,Black Mass,99775678,62575678,37200000,2015.csv,2015,0.6271636460340565,0.3728363539659435
662,Line Walker 2: Invisible Spy,99482027,296751,99185276,2019.csv,2019,0.002982960932229497,0.9970170390677705
663,The Lucky One,99357138,60457138,38900000,2012.csv,2012,0.6084830865397914,0.39151691346020856
664,Blue Jasmine,99104804,33405481,65699323,2013.csv,2013,0.3370722674553698,0.6629277325446302
665,Ode to My Father,99085291,2300121,96785170,2014.csv,2014,0.023213546398122804,0.9767864536018772
666,Young Detective Dee: Rise of the Sea Dragon,98774891,87783,98687108,2013.csv,2013,0.0008887177612780155,0.999111282238722
667,Spotlight,98690254,45055776,53634478,2015.csv,2015,0.45653723821604514,0.5434627617839549
668,Devil and Angel,98599942,131058,98468884,2015.csv,2015,0.0013291894228497619,0.9986708105771502
669,The Visit,98450062,65206105,33243957,2015.csv,2015,0.6623267032579421,0.3376732967420579
670,Riddick,98337295,42025135,56312160,2013.csv,2013,0.4273570368190421,0.572642963180958
671,Alpha,98203196,35857181,62346015,2018.csv,2018,0.36513252582940375,0.6348674741705962
672,Along With the Gods: The Last 49 Days,97962238,1200246,96761992,2018.csv,2018,0.012252129233715547,0.9877478707662845
673,A Simple Favor,97644617,53548586,44096031,2018.csv,2018,0.5484028474401206,0.4515971525598795
674,Safe Haven,97594140,71349120,26245020,2013.csv,2013,0.7310799603336839,0.26892003966631606
675,The Little Prince,97571250,1339152,96232098,2015.csv,2015,0.013724862600407395,0.9862751373995926
676,Evil Dead,97542952,54239856,43303096,2013.csv,2013,0.5560612518677925,0.44393874813220746
677,42,97470701,95020213,2450488,2013.csv,2013,0.9748592348792074,0.025140765120792555
678,Legend of the Demon Cat,97051623,0,97051623,2017.csv,2017,0.0,1.0
679,The Shack,96942115,57386418,39555697,2017.csv,2017,0.5919658138261168,0.40803418617388326
680,Boonie Bears: The Big Shrink,96845907,0,96845907,2018.csv,2018,0.0,1.0
681,Contraband,96262212,66528000,29734212,2012.csv,2012,0.6911123131057907,0.3088876868942093
682,Assassination,96119773,1904682,94215091,2015.csv,2015,0.019815714712518098,0.9801842852874819
683,Think Like a Man,96070507,91547205,4523302,2012.csv,2012,0.9529168509540602,0.04708314904593977
684,The Favourite,95918706,34366783,61551923,2018.csv,2018,0.35829072798375744,0.6417092720162426
685,Qing sheng,95721752,100026,95621726,2016.csv,2016,0.0010449662475881135,0.9989550337524119
686,The New King of Comedy,95618308,0,95618308,2019.csv,2019,0.0,1.0
687,Detective Conan: The Scarlet Bullet,95580715,0,95580715,2021.csv,2021,0.0,1.0
688,Poltergeist,95437994,47425125,48012869,2015.csv,2015,0.49692080703205055,0.5030791929679495
689,The Mortal Instruments: City of Bones,95396573,31165421,64231152,2013.csv,2013,0.32669329746258285,0.6733067025374172
690,Truth or Dare,95330493,41411015,53919478,2018.csv,2018,0.43439421843753606,0.565605781562464
691,Rush,95224595,26947624,68276971,2013.csv,2013,0.28299016656358583,0.7170098334364142
692,The Hustle,95017038,35417038,59600000,2019.csv,2019,0.3727440756467277,0.6272559243532723
693,Adoring,94975692,0,94975692,2019.csv,2019,0.0,1.0
694,Kill Mobile,94870905,0,94870905,2018.csv,2018,0.0,1.0
695,I Feel Pretty,94539426,48795601,45743825,2018.csv,2018,0.5161402291568811,0.48385977084311893
696,Veteran,94393020,1200627,93192393,2015.csv,2015,0.01271944684045494,0.9872805531595451
697,Masquerade,94268432,922921,93345511,2012.csv,2012,0.009790350602203715,0.9902096493977963
698,Police Story: Lockdown,94249025,0,94249025,2013.csv,2013,0.0,1.0
699,Fleet of Time,94244191,569280,93674911,2014.csv,2014,0.006040478399353017,0.9939595216006469
700,Dirty Grandpa,94073028,35593113,58479915,2016.csv,2016,0.378356195784407,0.6216438042155931
701,Ben-Hur,94061311,26410477,67650834,2016.csv,2016,0.2807793844166174,0.7192206155833827
702,Blockers,94017294,60311495,33705799,2018.csv,2018,0.6414936277574634,0.35850637224253656
703,In the Heart of the Sea,93920758,25020758,68900000,2015.csv,2015,0.26640285420183685,0.7335971457981632
704,The Man from Macau,93864936,0,93864936,2014.csv,2014,0.0,1.0
705,Kill Zone 2,93638358,11998,93626360,2015.csv,2015,0.00012813125151126635,0.9998718687484888
706,The Internship,93492844,44672764,48820080,2013.csv,2013,0.4778201420421011,0.5221798579578989
707,BlacKkKlansman,93400823,49275340,44125483,2018.csv,2018,0.5275685847008008,0.47243141529919924
708,Goosebumps 2: Haunted Halloween,93320380,46700633,46619747,2018.csv,2018,0.5004333780038187,0.49956662199618135
709,Money Monster,93282604,41012075,52270529,2016.csv,2016,0.43965405382551287,0.5603459461744872
710,Train to Busan,92742323,2129768,90612555,2016.csv,2016,0.022964359001445327,0.9770356409985547
711,Evangelion: 3.0+1.01 Thrice Upon a Time,92246218,0,92246218,2021.csv,2021,0.0,1.0
712,Southpaw,91970827,52421953,39548874,2015.csv,2015,0.5699845778270538,0.4300154221729462
713,Brave Hearts: Umizaru,91884352,0,91884352,2012.csv,2012,0.0,1.0
714,End Game,91824961,23149,91801812,2021.csv,2021,0.00025209920862367697,0.9997479007913763
715,Shadow,91708374,521396,91186978,2018.csv,2018,0.005685369582498541,0.9943146304175015
716,Crawl,91542097,39014193,52527904,2019.csv,2019,0.4261885436161682,0.5738114563838318
717,Five Feet Apart,91522094,45729221,45792873,2019.csv,2019,0.49965225883052894,0.500347741169471
718,Rambo: Last Blood,91490353,44819352,46671001,2019.csv,2019,0.4898806325514997,0.5101193674485003
719,Overboard,91244913,50316123,40928790,2018.csv,2018,0.551440308787406,0.448559691212594
720,Paranormal Activity: The Marked Ones,90894962,32462372,58432590,2014.csv,2014,0.35714159823291414,0.6428584017670859
721,My Big Fat Greek Wedding 2,90632641,59689605,30943036,2016.csv,2016,0.6585883887020351,0.34141161129796493
722,Sherlock Gnomes,90497778,43242871,47254907,2018.csv,2018,0.4778335110062039,0.522166488993796
723,Jojo Rabbit,90335025,33370906,56964119,2019.csv,2019,0.369412705647671,0.630587294352329
724,Old,90146510,48276510,41870000,2021.csv,2021,0.5355338770186444,0.4644661229813556
725,Detective Dee: The Four Heavenly Kings,90040771,262963,89777808,2018.csv,2018,0.0029204880975530517,0.9970795119024469
726,The Hundred-Foot Journey,89514453,54240821,35273632,2014.csv,2014,0.6059448411085079,0.39405515889149206
727,The Purge,89328627,64473115,24855512,2013.csv,2013,0.7217519978226017,0.2782480021773983
728,Collateral Beauty,88528280,31016021,57512259,2016.csv,2016,0.350351559976089,0.649648440023911
729,Line Walker,88228755,0,88228755,2016.csv,2016,0.0,1.0
730,This Is 40,88215156,67544505,20670651,2012.csv,2012,0.7656791424820469,0.23432085751795304
731,Dhoom 3,88031955,8031955,80000000,2013.csv,2013,0.09123908471645324,0.9087609152835467
732,Chasing the Dragon,87965942,456854,87509088,2017.csv,2017,0.005193532742478902,0.9948064672575211
733,Deliver Us from Evil,87937815,30577122,57360693,2014.csv,2014,0.3477130060600209,0.652286993939979
734,Serial (Bad) Weddings 2,87761988,0,87761988,2019.csv,2019,0.0,1.0
735,Tiger Zinda Hai,87320000,5560921,81759079,2017.csv,2017,0.06368439074667888,0.9363156092533211
736,Pain & Gain,87305549,49875291,37430258,2013.csv,2013,0.5712728637672274,0.42872713623277253
737,Sultan,87280000,6200000,81080000,2016.csv,2016,0.07103574702108158,0.9289642529789184
738,A Million Ways to Die in the West,87189756,43139300,44050456,2014.csv,2014,0.49477486781818725,0.5052251321818128
739,The Thieves,87126367,685839,86440528,2012.csv,2012,0.007871773191231536,0.9921282268087684
740,About Time,87100449,15322921,71777528,2013.csv,2013,0.17592241114623874,0.8240775888537613
741,American Dreams in China,87097067,0,87097067,2013.csv,2013,0.0,1.0
742,"Hello, Mrs. Money",86874070,0,86874070,2018.csv,2018,0.0,1.0
743,Snowpiercer,86758912,4563650,82195262,2013.csv,2013,0.052601512568530136,0.9473984874314698
744,Robin Hood,86489031,30824628,55664403,2018.csv,2018,0.35639927564918605,0.643600724350814
745,A Taxi Driver,86252940,1527829,84725111,2017.csv,2017,0.01771335562590678,0.9822866443740932
746,War Dogs,86234523,43034523,43200000,2016.csv,2016,0.4990405408747956,0.5009594591252045
747,Step Up All In,86165646,14904384,71261262,2014.csv,2014,0.1729736233858213,0.8270263766141787
748,I Can Only Imagine,86086881,83482352,2604529,2018.csv,2018,0.9697453436604353,0.030254656339564676
749,John Wick,86013056,43037835,42975221,2014.csv,2014,0.5003639796265348,0.49963602037346516
750,The Second Best Exotic Marigold Hotel,85978266,33078266,52900000,2015.csv,2015,0.38472822887588826,0.6152717711241118
751,Paper Towns,85512300,32000304,53511996,2015.csv,2015,0.37421872642882953,0.6257812735711704
752,The Possession,85446075,49130154,36315921,2012.csv,2012,0.5749843278348362,0.42501567216516384
753,Big Fish & Begonia,85409373,0,85409373,2016.csv,2016,0.0,1.0
754,Nerve,85251425,38583626,46667799,2016.csv,2016,0.4525862881470896,0.5474137118529103
755,Hidden Man,85170581,0,85170581,2018.csv,2018,0.0,1.0
756,Going in Style,84918541,45018541,39900000,2017.csv,2017,0.5301379471416025,0.46986205285839755
757,Sicario,84872444,46889293,37983151,2015.csv,2015,0.5524678068655593,0.44753219313444065
758,Carrie,84790678,35266619,49524059,2013.csv,2013,0.41592566343201076,0.5840743365679892
759,The Judge,84419388,47119388,37300000,2014.csv,2014,0.5581583699706517,0.44184163002934823
760,What to Expect When You're Expecting,84384002,41152203,43231799,2012.csv,2012,0.4876777828100639,0.5123222171899361
761,Leap!,84197417,2844490,81352927,2016.csv,2016,0.0337835779451524,0.9662164220548476
762,Finding Mr. Right,84112033,6945,84105088,2013.csv,2013,8.256844772733052e-05,0.9999174315522726
763,Our Times,83867493,0,83867493,2015.csv,2015,0.0,1.0
764,Mortal Kombat,83726031,42326031,41400000,2021.csv,2021,0.5055301259891324,0.49446987401086767
765,Mortal Engines,83672673,15951040,67721633,2018.csv,2018,0.19063619492591088,0.8093638050740891
766,Rings,83080890,27793018,55287872,2017.csv,2017,0.33452961324800445,0.6654703867519955
767,Suck Me Shakespeer 2,83027924,0,83027924,2015.csv,2015,0.0,1.0
768,Savages,82966152,47382068,35584084,2012.csv,2012,0.5711011883496778,0.4288988116503222
769,Once Upon A Time,82886178,485728,82400450,2017.csv,2017,0.005860180933906736,0.9941398190660933
770,The Fighter Pilot,82879386,0,82879386,2013.csv,2013,0.0,1.0
771,Sinister,82515113,48086903,34428210,2012.csv,2012,0.5827647960683275,0.4172352039316725
772,Act of Valor,82497035,70012847,12484188,2012.csv,2012,0.8486710704208945,0.1513289295791055
773,Hitman: Agent 47,82347656,22467450,59880206,2015.csv,2015,0.2728365455842483,0.7271634544157517
774,Tiny Times 3.0,82320000,0,82320000,2014.csv,2014,0.0,1.0
775,Miracle in Cell No. 7,82101723,0,82101723,2013.csv,2013,0.0,1.0
776,Ouija: Origin of Evil,81705746,35144505,46561241,2016.csv,2016,0.43013504827432825,0.5698649517256718
777,One Piece: Stampede,81562741,1298528,80264213,2019.csv,2019,0.01592060276640286,0.9840793972335972
778,Frankenweenie,81491068,35291068,46200000,2012.csv,2012,0.43306670124877983,0.5669332987512202
779,Wolf Warrior,81411331,0,81411331,2015.csv,2015,0.0,1.0
780,Gone with the Bullets,81387479,0,81387479,2014.csv,2014,0.0,1.0
781,iPartment the Movie,81096321,0,81096321,2018.csv,2018,0.0,1.0
782,Underworld: Blood Wars,81093313,30353973,50739340,2016.csv,2016,0.37430919858953104,0.625690801410469
783,Doraemon the Movie: Nobita's Treasure Island,80920916,0,80920916,2018.csv,2018,0.0,1.0
784,A Dog's Way Home,80708134,42004346,38703788,2019.csv,2019,0.5204474929379485,0.4795525070620515
785,Go Away Mr. Tumor,80606893,286639,80320254,2015.csv,2015,0.0035560110225312867,0.9964439889774687
786,Caught in Time,80543319,0,80543319,2020.csv,2020,0.0,1.0
787,Den of Thieves,80509622,44947622,35562000,2018.csv,2018,0.5582888216764947,0.44171117832350526
788,Muppets Most Wanted,80383113,51183113,29200000,2014.csv,2014,0.6367396221641727,0.36326037783582726
789,Hereditary,80200936,44069456,36131480,2018.csv,2018,0.5494880508626483,0.4505119491373517
790,The Wedding Ringer,79799880,64460211,15339669,2015.csv,2015,0.8077732823658381,0.19222671763416185
791,The Grey,79781695,51580236,28201459,2012.csv,2012,0.6465171741462751,0.353482825853725
792,Paradox,79226860,0,79226860,2017.csv,2017,0.0,1.0
793,Manchester by the Sea,78988148,47695371,31292777,2016.csv,2016,0.603829463124012,0.396170536875988
794,Lady Bird,78965611,48958273,30007338,2017.csv,2017,0.6199948608008617,0.3800051391991382
795,Paranormal Activity: The Ghost Dimension,78903124,18300124,60603000,2015.csv,2015,0.2319315519116835,0.7680684480883165
796,The Boss,78844582,63285885,15558697,2016.csv,2016,0.8026662504216207,0.1973337495783794
797,Code Blue: The Movie,78778562,0,78778562,2018.csv,2018,0.0,1.0
798,Spanish Affair,78768613,0,78768613,2014.csv,2014,0.0,1.0
799,The Attorney,78547586,557236,77990350,2013.csv,2013,0.007094247301247424,0.9929057526987526
800,The Family,78418811,36918811,41500000,2013.csv,2013,0.47079024189744473,0.5292097581025552
801,Scary Movie V,78378744,32015787,46362957,2013.csv,2013,0.4084753769465864,0.5915246230534136
802,R.I.P.D.,78324220,33618855,44705365,2013.csv,2013,0.4292268087700075,0.5707731912299925
803,Jackass Forever,78299422,57543732,20755690,2022.csv,2022,0.7349189882908714,0.26508101170912857
804,If I Stay,78274843,50474843,27800000,2014.csv,2014,0.6448411911857811,0.3551588088142189
805,Tag,78130625,54730625,23400000,2018.csv,2018,0.7005015638874001,0.2994984361125999
806,Head Full of Honey,78127384,0,78127384,2014.csv,2014,0.0,1.0
807,The Left Ear,78015473,0,78015473,2015.csv,2015,0.0,1.0
808,Boonie Bears: The Wild Life,77961427,0,77961427,2021.csv,2021,0.0,1.0
809,Shin Godzilla,77947607,1918403,76029204,2016.csv,2016,0.024611441888139043,0.975388558111861
810,Tiny Times 4.0,77750000,0,77750000,2015.csv,2015,0.0,1.0
811,Tiny Times,77717014,23462,77693552,2013.csv,2013,0.0003018901369525082,0.9996981098630475
812,Suck Me Shakespeer,77676735,0,77676735,2013.csv,2013,0.0,1.0
813,Candyman,77411570,61186570,16225000,2021.csv,2021,0.7904060077841077,0.20959399221589228
814,Diary of a Wimpy Kid: Dog Days,77229695,49008662,28221033,2012.csv,2012,0.6345831354118386,0.3654168645881613
815,Fantastica: A Boonie Bears Adventure,77151096,0,77151096,2017.csv,2017,0.0,1.0
816,Mike and Dave Need Wedding Dates,77068246,46009673,31058573,2016.csv,2016,0.596999093504736,0.40300090649526393
817,The Forever Purge,76994245,44539245,32455000,2021.csv,2021,0.5784749886176558,0.4215250113823442
818,"I, Frankenstein",76801179,19075290,57725889,2014.csv,2014,0.248372358971208,0.751627641028792
819,Sanju,76693052,7909317,68783735,2018.csv,2018,0.10312951165380665,0.8968704883461933
820,The Book Thief,76586316,21488481,55097835,2013.csv,2013,0.28057859578987976,0.7194214042101202
821,Cold Pursuit,76419755,32138862,44280893,2019.csv,2019,0.42055698817668286,0.5794430118233171
822,Kubo and the Two Strings,76249438,48023088,28226350,2016.csv,2016,0.6298156322148892,0.37018436778511077
823,Vice,76073488,47836282,28237206,2018.csv,2018,0.6288167304751426,0.3711832695248573
824,Widows,75984700,42402632,33582068,2018.csv,2018,0.5580417110286676,0.4419582889713324
825,Quo vado?,75878701,0,75878701,2016.csv,2016,0.0,1.0
826,Sicario: Day of the Soldado,75837743,50072235,25765508,2018.csv,2018,0.6602548153364743,0.33974518466352566
827,A Dog's Journey,75741734,22782371,52959363,2019.csv,2019,0.30079019579879174,0.6992098042012083
828,Bajrangi Bhaijaan,75547184,8178001,67369183,2015.csv,2015,0.10825024265629808,0.8917497573437019
829,Searching,75462037,26020957,49441080,2018.csv,2018,0.3448218208050758,0.6551781791949242
830,The Spy Who Dumped Me,75320680,33562069,41758611,2018.csv,2018,0.4455890334500432,0.5544109665499568
831,1921,75159828,0,75159828,2021.csv,2021,0.0,1.0
832,West Side Story,75119320,38460444,36658876,2021.csv,2021,0.5119913758537751,0.488008624146225
833,Animal World,74922830,0,74922830,2018.csv,2018,0.0,1.0
834,Boo! A Madea Halloween,74827344,73206343,1621001,2016.csv,2016,0.9783367828744529,0.021663217125547047
835,A Madea Family Funeral,74747725,73257045,1490680,2019.csv,2019,0.9800571856869222,0.019942814313077754
836,Crimson Peak,74679822,31090320,43589502,2014.csv,2014,0.4163148648104705,0.5836851351895295
837,Escape from Planet Earth,74597643,57012977,17584666,2013.csv,2013,0.7642731687916735,0.23572683120832652
838,Thermae Romae,74285251,0,74285251,2012.csv,2012,0.0,1.0
839,One Piece Film Z,74223861,0,74223861,2012.csv,2012,0.0,1.0
840,August: Osage County,74188937,37738810,36450127,2013.csv,2013,0.5086851426379111,0.4913148573620889
841,Miracles from Heaven,73983003,61705123,12277880,2016.csv,2016,0.8340445845378837,0.16595541546211634
842,Cats,73833348,27166770,46666578,2019.csv,2019,0.3679471503852162,0.6320528496147838
843,Charlie's Angels,73279888,17803077,55476811,2019.csv,2019,0.24294629107511737,0.7570537089248827
844,War Room,73267874,67790117,5477757,2015.csv,2015,0.9252365777666758,0.07476342223332426
845,To Rome with Love,73244881,16685867,56559014,2012.csv,2012,0.22780932636097806,0.7721906736390219
846,Here Comes the Boom,73100172,45290318,27809854,2012.csv,2012,0.6195651359069305,0.3804348640930694
847,My Old Classmate,73052128,0,73052128,2014.csv,2014,0.0,1.0
848,Bayside Shakedown the Final,72867395,0,72867395,2012.csv,2012,0.0,1.0
849,The Best Man Holiday,72835710,70525195,2310515,2013.csv,2013,0.9682777170703766,0.0317222829296234
850,The Bélier Family,72751538,0,72751538,2014.csv,2014,0.0,1.0
851,The Transporter Refueled,72629670,16029670,56600000,2015.csv,2015,0.22070415575342694,0.779295844246573
852,Amazing China,72506343,0,72506343,2018.csv,2018,0.0,1.0
853,Doctor Sleep,72381712,31581712,40800000,2019.csv,2019,0.4363217051290525,0.5636782948709476
854,Second Act,72282227,39282227,33000000,2018.csv,2018,0.5434562357908536,0.45654376420914644
855,What Men Want,72216294,54611903,17604391,2019.csv,2019,0.7562268841987377,0.24377311580126224
856,Run All Night,71561644,26461644,45100000,2015.csv,2015,0.3697741208963841,0.6302258791036159
857,Brick Mansions,71416730,20396829,51019901,2014.csv,2014,0.28560295325759105,0.714397046742409
858,The Counselor,71009334,16973715,54035619,2013.csv,2013,0.23903498376706364,0.7609650162329363
859,Son of God,70829270,59700064,11129206,2014.csv,2014,0.842872784090532,0.15712721590946793
860,I Am Not Madame Bovary,70826207,436798,70389409,2016.csv,2016,0.006167180461887504,0.9938328195381125
861,Spirited Away 2018 Re-release,70186029,1175067,69010962,2018.csv,2018,0.016742178133485795,0.9832578218665142
862,Think Like a Man Too,70181428,65182182,4999246,2014.csv,2014,0.9287668241803231,0.07123317581967696
863,See You Tomorrow,70065569,0,70065569,2016.csv,2016,0.0,1.0
864,Hitman's Wife's Bodyguard,70060492,38014727,32045765,2021.csv,2021,0.5425986303379086,0.45740136966209144
865,The Cabin in the Woods,69935600,42073277,27862323,2012.csv,2012,0.6016002865493397,0.39839971345066033
866,Sole a catinelle,69903094,0,69903094,2013.csv,2013,0.0,1.0
867,After,69518232,12138565,57379667,2019.csv,2019,0.1746098059570905,0.8253901940429095
868,Exit,69501772,470699,69031073,2019.csv,2019,0.006772474808268198,0.9932275251917319
869,Playing with Fire,69412425,44451847,24960578,2019.csv,2019,0.6404018732957392,0.3595981267042608
870,13 Hours,69411370,52853219,16558151,2015.csv,2015,0.7614490104431018,0.23855098955689824
871,Finding Nemo 2012 3D Release,69328283,41128283,28200000,2012.csv,2012,0.5932396017942634,0.4067603982057366
872,Anna Karenina,68929150,12816367,56112783,2012.csv,2012,0.18593536986891612,0.8140646301310839
873,Running Man,68782475,310978,68471497,2015.csv,2015,0.004521180722269735,0.9954788192777303
874,The Nut Job 2: Nutty by Nature,68743485,28370522,40372963,2017.csv,2017,0.41270124725273966,0.5872987527472603
875,The Call,68572631,51872378,16700253,2013.csv,2013,0.7564589143444124,0.24354108565558757
876,One Direction: This Is Us,68532898,28873374,39659524,2013.csv,2013,0.4213067715303678,0.5786932284696322
877,Stalingrad,68316452,1013945,67302507,2013.csv,2013,0.014841886109659207,0.9851581138903408
878,The Watch,68267862,35353000,32914862,2012.csv,2012,0.5178571433802922,0.4821428566197078
879,Moonrise Kingdom,68263166,45512466,22750700,2012.csv,2012,0.6667207026407185,0.3332792973592816
880,The Yin-Yang Master: Dream of Eternity,68000000,0,68000000,2020.csv,2020,0.0,1.0
881,Shoplifters,67999335,3313513,64685822,2018.csv,2018,0.04872860889007223,0.9512713911099278
882,A Beautiful Day in the Neighborhood,67925733,61704055,6221678,2019.csv,2019,0.9084046984078921,0.09159530159210796
883,Jersey Boys,67647013,47047013,20600000,2014.csv,2014,0.6954780545890474,0.30452194541095257
884,The Secret of the Gods,67537798,0,67537798,2012.csv,2012,0.0,1.0
885,12 Strong,67450815,45819713,21631102,2018.csv,2018,0.6793055502739292,0.32069444972607075
886,American Assassin,67234188,36249674,30984514,2017.csv,2017,0.5391553773208356,0.4608446226791644
887,War,67179155,4654000,62525155,2019.csv,2019,0.06927744178979328,0.9307225582102068
888,The Giver,66980456,45090374,21890082,2014.csv,2014,0.6731870263767687,0.32681297362323125
889,Madea's Witness Protection,66899242,65653242,1246000,2012.csv,2012,0.9813749758181116,0.018625024181888338
890,Mulan,66800000,0,66800000,2020.csv,2020,0.0,1.0
891,Selma,66787908,52076908,14711000,2014.csv,2014,0.779735577284439,0.22026442271556101
892,Dog,66757302,56344938,10412364,2022.csv,2022,0.8440265905293776,0.1559734094706224
893,A Violent Prosecutor,66736633,0,66736633,2015.csv,2015,0.0,1.0
894,Victoria & Abdul,66558465,22245070,44313395,2017.csv,2017,0.33421849497280326,0.6657815050271968
895,"Love, Simon",66316289,40826341,25489948,2018.csv,2018,0.615630663531248,0.38436933646875204
896,Mile 22,66308758,36108758,30200000,2018.csv,2018,0.5445548836851989,0.4554451163148011
897,One Piece Film: Gold,66207073,423593,65783480,2016.csv,2016,0.00639800221949096,0.9936019977805091
898,Life of the Party,65859911,53059911,12800000,2018.csv,2018,0.8056480823364611,0.1943519176635389
899,Beijing Love Story,65842375,428318,65414057,2014.csv,2014,0.0065052027664554936,0.9934947972335445
900,The Age of Adaline,65663276,42629776,23033500,2015.csv,2015,0.6492179281460158,0.35078207185398425
901,Eiga Doraemon: Nobita no getsumen tansaki,65406606,0,65406606,2019.csv,2019,0.0,1.0
902,Moonlight,65336603,27854932,37481671,2016.csv,2016,0.42632966394044086,0.5736703360595592
903,The House That Never Dies,65220000,0,65220000,2014.csv,2014,0.0,1.0
904,Stand by Me Doraemon 2,65201374,0,65201374,2020.csv,2020,0.0,1.0
905,The Pirates,64858224,415775,64442449,2014.csv,2014,0.006410520892462304,0.9935894791075377
906,God's Not Dead,64667874,60755732,3912142,2014.csv,2014,0.9395040882277961,0.060495911772203925
907,Happy Death Day 2U,64600152,28148130,36452022,2019.csv,2019,0.43572854131984085,0.5642714586801592
908,L Storm,64517456,0,64517456,2018.csv,2018,0.0,1.0
909,Monster Trucks,64493915,33370166,31123749,2016.csv,2016,0.5174157282900255,0.4825842717099745
910,Monk Comes Down the Mountain,64455686,0,64455686,2015.csv,2015,0.0,1.0
911,Capernaum,64417003,1661096,62755907,2018.csv,2018,0.025786607923997954,0.974213392076002
912,Fences,64414761,57682904,6731857,2016.csv,2016,0.8954920130806664,0.10450798691933359
913,Zhongkui: Snow Girl and the Dark Crystal,64325947,165428,64160519,2015.csv,2015,0.002571714956641058,0.9974282850433589
914,Isle of Dogs,64241499,32015231,32226268,2018.csv,2018,0.49835747139088393,0.5016425286091161
915,Suck Me Shakespeer 3,64236772,0,64236772,2017.csv,2017,0.0,1.0
916,The Rescue,64203587,18797,64184790,2020.csv,2020,0.0002927718041672656,0.9997072281958327
917,Thunder and the House of Magic,64197205,4091,64193114,2013.csv,2013,6.372551577595941e-05,0.9999362744842241
918,The Danish Girl,64191523,11114018,53077505,2015.csv,2015,0.1731384064528271,0.8268615935471729
919,The Boy,64188367,35819556,28368811,2015.csv,2015,0.5580381255064488,0.4419618744935511
920,The Grandmaster,64076736,6594959,57481777,2013.csv,2013,0.10292282990194757,0.8970771700980524
921,The Pirate Fairy,63998725,0,63998725,2014.csv,2014,0.0,1.0
922,The Inbetweeners 2,63852235,0,63852235,2014.csv,2014,0.0,1.0
923,"Hail, Caesar!",63647656,30498085,33149571,2016.csv,2016,0.4791705919225054,0.5208294080774947
924,Begin Again,63464861,16170632,47294229,2014.csv,2014,0.25479661887229216,0.7452033811277078
925,Side Effects,63414135,32172757,31241378,2013.csv,2013,0.5073436229950941,0.49265637700490594
926,The Host,63365859,26627201,36738658,2013.csv,2013,0.42021368320754554,0.5797863167924544
927,Belle,63322814,4006300,59316514,2021.csv,2021,0.06326787688241398,0.936732123117586
928,The Hundred Regiments Offensive,63230000,0,63230000,2015.csv,2015,0.0,1.0
929,Detective Conan: Crimson Love Letter,63144805,0,63144805,2017.csv,2017,0.0,1.0
930,The Longest Ride,62944815,37446117,25498698,2015.csv,2015,0.5949039170263667,0.4050960829736333
931,Unfriended,62882090,32482090,30400000,2015.csv,2015,0.5165555088897331,0.4834444911102668
932,The Mountain Between Us,62832209,30348555,32483654,2017.csv,2017,0.48300951825519933,0.5169904817448007
933,The Star,62812974,40852824,21960150,2017.csv,2017,0.65038830990553,0.34961169009446996
934,The Nice Guys,62788218,36261763,26526455,2016.csv,2016,0.5775249585837904,0.4224750414162097
935,Beauty and the Beast 2012 3D Release,62767829,47617067,15150762,2012.csv,2012,0.7586221757008674,0.2413778242991326
936,Runner Runner,62675095,19316646,43358449,2013.csv,2013,0.3082028994132358,0.6917971005867641
937,How to Be a Latin Lover,62547032,32149404,30397628,2017.csv,2017,0.5140036700702281,0.4859963299297719
938,The White Haired Witch of Lunar Kingdom,62515046,0,62515046,2014.csv,2014,0.0,1.0
939,Andhadhun,62475342,1193046,61282296,2018.csv,2018,0.019096270013215774,0.9809037299867842
940,47 Meters Down,62187529,44307191,17880338,2017.csv,2017,0.7124771109654477,0.28752288903455225
941,White Snake,62098770,34730,62064040,2019.csv,2019,0.0005592703365944285,0.9994407296634056
942,Brooklyn,62076141,38322743,23753398,2015.csv,2015,0.6173506017392415,0.3826493982607585
943,"Dragon Ball Z: Resurrection ""F""",61768190,8008363,53759827,2015.csv,2015,0.1296518968744268,0.8703481031255732
944,"Everything, Everything",61621140,34121140,27500000,2017.csv,2017,0.5537245821807256,0.4462754178192744
945,Woman in Gold,61619773,33307793,28311980,2015.csv,2015,0.540537418078447,0.459462581921553
946,The Face Reader,61559184,515876,61043308,2013.csv,2013,0.008380163063889865,0.9916198369361101
947,Krampus,61548707,42725475,18823232,2015.csv,2015,0.694173396688902,0.305826603311098
948,Bombshell,61404394,31762808,29641586,2019.csv,2019,0.5172725587032094,0.48272744129679057
949,Ashfall,61354854,372562,60982292,2019.csv,2019,0.006072249801132279,0.9939277501988677
950,Astérix and Obélix: God Save Britannia,61319383,0,61319383,2012.csv,2012,0.0,1.0
951,The Legend of Hercules,61279452,18848538,42430914,2013.csv,2013,0.30758333152195944,0.6924166684780406
952,The Walk,61181942,10137502,51044440,2014.csv,2014,0.16569434817874856,0.8343056518212515
953,Doraemon: Great Adventure in the Antarctic Kachi Kochi,61153455,0,61153455,2017.csv,2017,0.0,1.0
954,Ma,61105672,45896028,15209644,2019.csv,2019,0.7510927627144007,0.24890723728559927
955,Snatched,60845711,45852178,14993533,2017.csv,2017,0.7535811028652455,0.24641889713475448
956,Kick-Ass 2,60795985,28795985,32000000,2013.csv,2013,0.4736494523445915,0.5263505476554085
957,Ron's Gone Wrong,60692022,23009270,37682752,2021.csv,2021,0.37911523198222,0.62088476801778
958,Love You Forever,60670799,0,60670799,2020.csv,2020,0.0,1.0
959,The Founding of an Army,60600361,0,60600361,2017.csv,2017,0.0,1.0
960,Evangelion: 3.0 You Can (Not) Redo,60488344,174945,60313399,2012.csv,2012,0.002892210109107963,0.997107789890892
961,My Little Pony: The Movie,60330833,21885107,38445726,2017.csv,2017,0.3627516132588456,0.6372483867411544
962,The Perfect Guy,60273173,57027435,3245738,2015.csv,2015,0.9461495415215655,0.05385045847843451
963,A Haunted House,60159584,40041683,20117901,2013.csv,2013,0.6655910885288037,0.33440891147119634
964,Beautiful Creatures,60052138,19452138,40600000,2013.csv,2013,0.323920823601651,0.676079176398349
965,My Best Summer,60011073,0,60011073,2019.csv,2019,0.0,1.0
966,Forever Young,59981902,149761,59832141,2015.csv,2015,0.0024967697756566637,0.9975032302243433
967,Adrift,59945012,31445012,28500000,2018.csv,2018,0.5245642790095696,0.47543572099043035
968,Quartet,59520298,18390117,41130181,2012.csv,2012,0.3089721929819639,0.6910278070180361
969,Rock of Ages,59418613,38518613,20900000,2012.csv,2012,0.6482583664482373,0.35174163355176263
970,Miss Granny,59396311,234573,59161738,2015.csv,2015,0.003949285671967069,0.9960507143280329
971,Molly's Game,59284015,28780744,30503271,2017.csv,2017,0.48547224745152634,0.5145277525484736
972,The Devotion of Suspect X,59035664,686435,58349229,2017.csv,2017,0.011627463019641822,0.9883725369803582
973,The Gift,58978653,43787265,15191388,2015.csv,2015,0.742425653566554,0.257574346433446
974,Miss Granny,58940254,0,58940254,2014.csv,2014,0.0,1.0
975,A Walk Among the Tombstones,58834384,26307600,32526784,2014.csv,2014,0.44714668891578774,0.5528533110842122
976,Shock Wave,58815633,0,58815633,2017.csv,2017,0.0,1.0
977,Cloudy Mountain,58281703,0,58281703,2021.csv,2021,0.0,1.0
978,Huo guo ying xiong,58106427,779818,57326609,2016.csv,2016,0.013420511985705126,0.9865794880142948
979,L.O.R.D: Legend of Ravaging Dynasties,58089494,350456,57739038,2016.csv,2016,0.0060330358532646195,0.9939669641467354
980,Snitch,57824674,42930462,14894212,2013.csv,2013,0.7424246265530179,0.25757537344698217
981,Dolphin Tale 2,57824533,42024533,15800000,2014.csv,2014,0.7267595745217692,0.27324042547823085
982,Nine Lives,57814445,19700032,38114413,2016.csv,2016,0.3407458464748732,0.6592541535251268
983,That's My Boy,57719093,36931089,20788004,2012.csv,2012,0.6398418110970663,0.3601581889029337
984,Avatar 2021 Re-release,57700000,0,57700000,2021.csv,2021,0.0,1.0
985,Goldbuster,57628292,186135,57442157,2017.csv,2017,0.0032299239408310073,0.996770076059169
986,Ready or Not,57615777,28714231,28901546,2019.csv,2019,0.4983744469852416,0.5016255530147584
987,The Physician,57284237,0,57284237,2013.csv,2013,0.0,1.0
988,Jade Dynasty,57149764,0,57149764,2019.csv,2019,0.0,1.0
989,The 15:17 to Paris,57076286,36276286,20800000,2018.csv,2018,0.6355754472181319,0.36442455278186814
990,All the Money in the World,56996304,25113707,31882597,2017.csv,2017,0.44061992160053043,0.5593800783994696
991,Zoolander 2,56722693,28848693,27874000,2016.csv,2016,0.5085917377018754,0.4914082622981247
992,You Are My Sunshine,56640000,0,56640000,2015.csv,2015,0.0,1.0
993,Das perfekte Geheimnis,56573047,0,56573047,2019.csv,2019,0.0,1.0
994,The Big Sick,56411585,42873127,13538458,2017.csv,2017,0.7600057151381228,0.2399942848618772
995,A or B,56239049,0,56239049,2018.csv,2018,0.0,1.0
996,Nezha Reborn,56088478,0,56088478,2021.csv,2021,0.0,1.0
997,The Big Shot,56040681,0,56040681,2019.csv,2019,0.0,1.0
998,The Odd Life of Timothy Green,56012642,51854875,4157767,2012.csv,2012,0.9257709179295631,0.07422908207043688
999,Gongjo,55972241,475618,55496623,2017.csv,2017,0.008497390697649572,0.9915026093023505
1000,Firestorm,55754766,0,55754766,2013.csv,2013,0.0,1.0
1001,Dallas Buyers Club,55736588,27298285,28438303,2013.csv,2013,0.4897731630073947,0.5102268369926053
1002,Nobody,55705035,27568035,28137000,2021.csv,2021,0.4948930558970118,0.5051069441029882
1003,All Eyez on Me,55668698,44922302,10746396,2017.csv,2017,0.806958014358446,0.1930419856415539
1004,Lawless,55404159,37400127,18004032,2012.csv,2012,0.6750418682467502,0.3249581317532498
1005,End of Watch,55078146,41003371,14074775,2012.csv,2012,0.744458083247755,0.2555419167522451
1006,Hellboy,55064690,21903748,33160942,2019.csv,2019,0.39778209956325916,0.6022179004367408
1007,Wolf Children,55045228,0,55045228,2012.csv,2012,0.0,1.0
1008,Barbershop: The Next Cut,55030051,54030051,1000000,2016.csv,2016,0.9818281106081476,0.018171889391852464
1009,Downsizing,55003890,24449754,30554136,2017.csv,2017,0.44450954287051336,0.5554904571294866
1010,St. Vincent,54837234,44137712,10699522,2014.csv,2014,0.8048858190039272,0.19511418099607286
1011,The Three Stooges,54819301,44338224,10481077,2012.csv,2012,0.8088068105793614,0.19119318942063854
1012,Go Brother!,54663060,0,54663060,2018.csv,2018,0.0,1.0
1013,Early Man,54622814,8267544,46355270,2018.csv,2018,0.15135697695838227,0.8486430230416178
1014,The Age of Shadows,54491162,541719,53949443,2016.csv,2016,0.009941410315309481,0.9900585896846905
1015,No Escape,54418872,27288872,27130000,2015.csv,2015,0.5014597141962075,0.4985402858037925
1016,No Good Deed,54323210,52543632,1779578,2014.csv,2014,0.9672409270365282,0.03275907296347178
1017,Upcoming,54300000,0,54300000,2021.csv,2021,0.0,1.0
1018,The Five-Year Engagement,54169363,28835528,25333835,2012.csv,2012,0.5323217110749484,0.4676782889250516
1019,"I, Tonya",53939297,30014539,23924758,2017.csv,2017,0.5564503185868366,0.4435496814131634
1020,Peppermint,53918723,35418723,18500000,2018.csv,2018,0.6568909838610235,0.34310901613897643
1021,Long Shot,53873809,30316271,23557538,2019.csv,2019,0.5627274470234692,0.4372725529765308
1022,1987: When the Day Comes,53834292,0,53834292,2017.csv,2017,0.0,1.0
1023,Overheard 3,53493428,0,53493428,2014.csv,2014,0.0,1.0
1024,Supercondriaque,53425036,0,53425036,2014.csv,2014,0.0,1.0
1025,A Madea Christmas,53396635,52543354,853281,2013.csv,2013,0.9840199480735069,0.01598005192649312
1026,Sinister 2,53329150,27740955,25588195,2015.csv,2015,0.5201837081596088,0.4798162918403912
1027,A Chinese Odyssey: Part Three,53306108,0,53306108,2016.csv,2016,0.0,1.0
1028,3 Days to Kill,53260230,30697999,22562231,2014.csv,2014,0.5763775147046868,0.4236224852953132
1029,Temptation: Confessions of a Marriage Counselor,53143144,51975354,1167790,2013.csv,2013,0.9780255756038823,0.021974424396117777
1030,Delivery Man,53120346,30664106,22456240,2013.csv,2013,0.5772572716299702,0.4227427283700298
1031,The Outlaws,52946454,0,52946454,2017.csv,2017,0.0,1.0
1032,Man in Love,52946097,0,52946097,2021.csv,2021,0.0,1.0
1033,Detective Conan: Sunflowers of Inferno,52920296,0,52920296,2015.csv,2015,0.0,1.0
1034,Prem Ratan Dhan Payo,52715771,4364639,48351132,2015.csv,2015,0.08279569694617575,0.9172043030538243
1035,Break Through the Darkness,52700000,0,52700000,2021.csv,2021,0.0,1.0
1036,Rurouni Kenshin Part II: Kyoto Inferno,52696176,0,52696176,2014.csv,2014,0.0,1.0
1037,Wild,52501541,37880356,14621185,2014.csv,2014,0.7215094124570554,0.2784905875429447
1038,Tunnel,52444295,568876,51875419,2016.csv,2016,0.010847242774452398,0.9891527572255476
1039,The Boy Next Door,52425855,35423380,17002475,2015.csv,2015,0.6756853083273511,0.3243146916726489
1040,The Night Before,52395996,43047372,9348624,2015.csv,2015,0.8215775113808315,0.17842248861916854
1041,Greenland,52300000,0,52300000,2020.csv,2020,0.0,1.0
1042,Hollywood Adventures,52265070,0,52265070,2015.csv,2015,0.0,1.0
1043,Tolo Tolo,52186426,0,52186426,2020.csv,2020,0.0,1.0
1044,Patriots Day,52185751,31886361,20299390,2016.csv,2016,0.6110166163940038,0.3889833836059962
1045,My Beloved Bodyguard,52165873,0,52165873,2016.csv,2016,0.0,1.0
1046,The Finest Hours,52099090,27569558,24529532,2016.csv,2016,0.5291754232175648,0.47082457678243517
1047,Teen Titans GO! To the Movies,52090236,29790236,22300000,2018.csv,2018,0.5718967370391641,0.4281032629608359
1048,Escape Room: Tournament of Champions,51914753,25314753,26600000,2021.csv,2021,0.4876215629880778,0.5123784370119222
1049,"Yo-kai Watch Movie: It's the Secret of Birth, Meow!",51838845,257343,51581502,2015.csv,2015,0.004964288845555876,0.9950357111544441
1050,Slender Man,51738549,30569484,21169065,2018.csv,2018,0.5908454061979975,0.4091545938020025
1051,Schemes in Antiques,51637422,36501,51600921,2021.csv,2021,0.0007068710750122265,0.9992931289249878
1052,Master,51636415,597251,51039164,2016.csv,2016,0.011566469128424194,0.9884335308715758
1053,Breaking In,51411620,46840590,4571030,2018.csv,2018,0.9110895552406246,0.08891044475937541
1054,Cry Me a Sad River,51400614,0,51400614,2018.csv,2018,0.0,1.0
1055,Hot Pursuit,51380201,34580201,16800000,2015.csv,2015,0.6730258022929883,0.3269741977070117
1056,Once Upon a Deadpool 2018 Re-release,51349833,6100309,45249524,2018.csv,2018,0.1187990036890675,0.8812009963109325
1057,Simmba,51329025,5102129,46226896,2018.csv,2018,0.09940046591572702,0.900599534084273
1058,The 100 Year-Old Man Who Climbed Out the Window and Disappeared,51167572,944193,50223379,2013.csv,2013,0.018452956884489263,0.9815470431155108
1059,Magic in the Moonlight,51029361,10539326,40490035,2014.csv,2014,0.20653454782629946,0.7934654521737006
1060,Red Dawn,50950296,44806783,6143513,2012.csv,2012,0.8794214463444923,0.12057855365550771
1061,Doraemon the Movie: Nobita and the Birth of Japan,50939840,0,50939840,2016.csv,2016,0.0,1.0
1062,Vanguard,50866901,793525,50073376,2020.csv,2020,0.015600026429760288,0.9843999735702397
1063,Kingdom,50574061,0,50574061,2019.csv,2019,0.0,1.0
1064,The Himalayas,50544493,696717,49847776,2015.csv,2015,0.013784231647154914,0.9862157683528451
1065,Dragon Ball Z: Battle of Gods,50461371,2553002,47908369,2013.csv,2013,0.05059319533747904,0.9494068046625209
1066,About Last Night,50445860,48637684,1808176,2014.csv,2014,0.9641561071612219,0.03584389283877805
1067,Breakthrough,50444358,40713082,9731276,2019.csv,2019,0.8070889117074302,0.1929110882925698
1068,Just Mercy,50401502,36001502,14400000,2019.csv,2019,0.7142942287711981,0.28570577122880186
1069,Red Tails,50365498,49876377,489121,2012.csv,2012,0.9902885701636466,0.009711429836353449
1070,"Monsters, Inc. 2012 3D Release",50207820,34043006,16164814,2012.csv,2012,0.6780419066193274,0.32195809338067255
1071,HOUBA! On the Trail of the Marsupilami,50146474,0,50146474,2012.csv,2012,0.0,1.0
1072,Uncut Gems,50023780,50023780,0,2019.csv,2019,1.0,0.0
1073,Dearest 2014 Re-release,50000583,0,50000583,2014.csv,2014,0.0,1.0
1074,Family is Family,49954866,0,49954866,2018.csv,2018,0.0,1.0
1075,21 Bridges,49939757,28539757,21400000,2019.csv,2019,0.5714836978481894,0.42851630215181064
1076,The Wailing,49851770,786633,49065137,2016.csv,2016,0.015779439727014708,0.9842205602729853
1077,Luca,49750471,0,49750471,2021.csv,2021,0.0,1.0
1078,The Boy and the Beast,49714378,490643,49223735,2015.csv,2015,0.009869237426645467,0.9901307625733545
1079,Two Is a Family,49619118,0,49619118,2016.csv,2016,0.0,1.0
1080,Song of Youth,49615508,0,49615508,2019.csv,2019,0.0,1.0
1081,Surprise,49567466,0,49567466,2015.csv,2015,0.0,1.0
1082,Death Wish,49562710,34017028,15545682,2018.csv,2018,0.6863431801852643,0.3136568198147357
1083,The Grudge,49511319,21221803,28289516,2019.csv,2019,0.4286252806151256,0.5713747193848744
1084,Tad: The Lost Explorer,49490859,0,49490859,2012.csv,2012,0.0,1.0
1085,Entourage,49263404,32363404,16900000,2015.csv,2015,0.6569461582476112,0.34305384175238884
1086,A Turtle's Tale 2: Sammy's Escape from Paradise,49261830,0,49261830,2012.csv,2012,0.0,1.0
1087,The New Mutants,49169594,23852659,25316935,2020.csv,2020,0.4851099441659006,0.5148900558340994
1088,Marry Me,49103975,22404975,26699000,2022.csv,2022,0.45627619759907423,0.5437238024009258
1089,Little,48987096,40860481,8126615,2019.csv,2019,0.8341070268790786,0.16589297312092147
1090,Whiplash,48982041,13092000,35890041,2014.csv,2014,0.2672816349159481,0.732718365084052
1091,Never Gone,48980792,96421,48884371,2016.csv,2016,0.0019685471806989156,0.9980314528193011
1092,The Berlin File,48972848,665210,48307638,2013.csv,2013,0.013583241064518036,0.986416758935482
1093,Trouble with the Curve,48963137,35763137,13200000,2012.csv,2012,0.7304094302617906,0.2695905697382094
1094,Luck-Key,48913975,466505,48447470,2016.csv,2016,0.00953725392385305,0.9904627460761469
1095,Florence Foster Jenkins,48902953,27383770,21519183,2016.csv,2016,0.559961481262696,0.44003851873730404
1096,The Woman in Black 2: Angel of Death,48854305,26501323,22352982,2015.csv,2015,0.5424562482262311,0.457543751773769
1097,Bleeding Steel,48825526,0,48825526,2017.csv,2017,0.0,1.0
1098,Fantasy Island,48811343,27309289,21502054,2020.csv,2020,0.5594865316449088,0.44051346835509114
1099,Isn't It Romantic,48791187,48791187,0,2019.csv,2019,1.0,0.0
1100,Mother's Day,48782670,32492859,16289811,2016.csv,2016,0.6660738126879894,0.33392618731201057
1101,Concussion,48623572,34542474,14081098,2015.csv,2015,0.7104059323325732,0.28959406766742685
1102,Her,48517427,25568251,22949176,2013.csv,2013,0.5269910747740189,0.47300892522598115
1103,The Legend of Hei,48507082,0,48507082,2019.csv,2019,0.0,1.0
1104,Logan Lucky,48453605,27780977,20672628,2017.csv,2017,0.5733521169374292,0.4266478830625709
1105,Homefront,48449416,20158898,28290518,2013.csv,2013,0.4160813414138986,0.5839186585861015
1106,Chef,48428048,31424003,17004045,2014.csv,2014,0.6488802315550691,0.3511197684449309
1107,Boo 2! A Madea Halloween,48333932,47319572,1014360,2017.csv,2017,0.979013501322425,0.020986498677575
1108,The Last Stand,48330757,12050299,36280458,2013.csv,2013,0.24932982117370933,0.7506701788262907
1109,Boyhood,48137666,25352281,22785385,2014.csv,2014,0.5266620321807874,0.4733379678192125
1110,21 & Over,48065672,25682380,22383292,2013.csv,2013,0.5343185465086184,0.4656814534913815
1111,Sky Hunter,48065601,0,48065601,2017.csv,2017,0.0,1.0
1112,Countdown,48021766,25621766,22400000,2019.csv,2019,0.5335448513076341,0.4664551486923659
1113,After We Collided,47990414,2386483,45603931,2020.csv,2020,0.04972832699463689,0.9502716730053631
1114,"From Today, It's My Turn: The Movie",47866854,0,47866854,2020.csv,2020,0.0,1.0
1115,Midsommar,47863365,27426361,20437004,2019.csv,2019,0.5730136399728686,0.4269863600271314
1116,Queen & Slim,47860909,43808310,4052599,2019.csv,2019,0.9153254903704399,0.08467450962956011
1117,Phantom Thread,47756590,21198205,26558385,2017.csv,2017,0.4438802058522185,0.5561197941477815
1118,"Yo-kai Watch Movie: It's the Secret of Birth, Meow! 2016 Re-release",47642462,0,47642462,2016.csv,2016,0.0,1.0
1119,Trolls 2: World Tour,47641355,450000,47191355,2020.csv,2020,0.009445575173082294,0.9905544248269177
1120,Man on a Ledge,47636031,18620000,29016031,2012.csv,2012,0.3908805920459662,0.6091194079540337
1121,Inside Men,47616503,0,47616503,2015.csv,2015,0.0,1.0
1122,The Dead End,47600000,0,47600000,2015.csv,2015,0.0,1.0
1123,Coming Home,47587984,377607,47210377,2014.csv,2014,0.007934923236084135,0.9920650767639159
1124,47 Meters Down: Uncaged,47582563,22260900,25321663,2019.csv,2019,0.46783734621441053,0.5321626537855895
1125,Boonie Bears Winter,47581416,0,47581416,2015.csv,2015,0.0,1.0
1126,Beauty and the Beast,47430624,0,47430624,2014.csv,2014,0.0,1.0
1127,The Magic Tuche,47427990,0,47427990,2018.csv,2018,0.0,1.0
1128,Nightcrawler,47398992,32381217,15017775,2014.csv,2014,0.683162565988745,0.3168374340112549
1129,Rough Night,47347283,22105643,25241640,2017.csv,2017,0.466883031070653,0.533116968929347
1130,Texas Chainsaw,47340586,34341945,12998641,2013.csv,2013,0.7254228961170865,0.2745771038829135
1131,Don't Breathe 2,47312950,32712950,14600000,2021.csv,2021,0.6914164092494761,0.3085835907505239
1132,A Monster Calls,47309313,3740823,43568490,2016.csv,2016,0.07907159843982516,0.9209284015601749
1133,Tiny Times 2.0,47289937,43788,47246149,2013.csv,2013,0.0009259475224084143,0.9990740524775916
1134,Golden Job,47287851,285795,47002056,2018.csv,2018,0.006043729921243407,0.9939562700787566
1135,Mortdecai,47275695,7696134,39579561,2015.csv,2015,0.16279261468287246,0.8372073853171276
1136,Switch,47164301,0,47164301,2013.csv,2013,0.0,1.0
1137,The Place Beyond the Pines,47052899,21403519,25649380,2013.csv,2013,0.45488204669387106,0.5451179533061289
1138,Son of Bigfoot,47046281,289308,46756973,2017.csv,2017,0.006149434000957483,0.9938505659990425
1139,My Hero Academia: World Heroes' Mission,46924698,12271658,34653040,2021.csv,2021,0.26151810289754024,0.7384818971024598
1140,Parker,46922566,17616641,29305925,2013.csv,2013,0.3754406994706982,0.6245593005293019
1141,Mary Queen of Scots,46712809,16468499,30244310,2018.csv,2018,0.35254782044899075,0.6474521795510092
1142,Uncle Drew,46664414,42469946,4194468,2018.csv,2018,0.9101142039413588,0.08988579605864118
1143,Three Seconds,46596415,0,46596415,2017.csv,2017,0.0,1.0
1144,The Big Wedding,46522137,21819348,24702789,2013.csv,2013,0.4690100112984922,0.5309899887015078
1145,Badges of Fury,46495296,0,46495296,2013.csv,2013,0.0,1.0
1146,Risen,46432579,36880033,9552546,2016.csv,2016,0.7942706133122608,0.20572938668773924
1147,Acrimony,46403669,43549096,2854573,2018.csv,2018,0.9384838944523978,0.061516105547602284
1148,A Werewolf Boy,46282588,342922,45939666,2012.csv,2012,0.007409309090494248,0.9925906909095058
1149,The French Dispatch,46281956,16124375,30157581,2021.csv,2021,0.3483944153094999,0.6516055846905001
1150,The Thousand Faces of Dunjia,46263237,124187,46139050,2017.csv,2017,0.002684356047113608,0.9973156439528864
1151,The Battleship Island,46183383,1104957,45078426,2017.csv,2017,0.023925423566307388,0.9760745764336927
1152,Doraemon: Nobita and the Island of Miracles ~Animal Adventure~,46180706,0,46180706,2012.csv,2012,0.0,1.0
1153,Hanson and the Beast,46154323,0,46154323,2017.csv,2017,0.0,1.0
1154,Eddie the Eagle,46152800,15789389,30363411,2016.csv,2016,0.342111182853478,0.657888817146522
1155,The World's End,46089287,26004851,20084436,2013.csv,2013,0.5642276696534707,0.43577233034652935
1156,Gekijouban Tenpesuto 3D 2012 Re-release,46008255,0,46008255,2012.csv,2012,0.0,1.0
1157,Let's Get Married,45972724,462918,45509806,2015.csv,2015,0.010069405502271303,0.9899305944977287
1158,Asterix: The Secret of the Magic Potion,45972321,1271953,44700368,2018.csv,2018,0.027667800370575157,0.9723321996294249
1159,Gintama Live Action the Movie,45746967,0,45746967,2017.csv,2017,0.0,1.0
1160,Somewhere Only We Know,45737711,482341,45255370,2015.csv,2015,0.010545805407708313,0.9894541945922917
1161,Chasing the Dragon II: Wild Wild Bunch,45733356,196634,45536722,2019.csv,2019,0.004299575128490461,0.9957004248715096
1162,"McFarland, USA",45710059,44482410,1227649,2015.csv,2015,0.9731426949153577,0.026857305084642312
1163,Judy,45701880,24313888,21387992,2019.csv,2019,0.5320106743967644,0.4679893256032356
1164,Guilty of Mind,45698503,0,45698503,2017.csv,2017,0.0,1.0
1165,Earth to Echo,45681062,38934842,6746220,2014.csv,2014,0.8523191076424624,0.14768089235753756
1166,That Awkward Moment,45640143,26068955,19571188,2014.csv,2014,0.5711847791537376,0.42881522084626245
1167,Bajrangi Bhaijaan 2018 Re-release,45579004,0,45579004,2018.csv,2018,0.0,1.0
1168,Hero,45565534,88675,45476859,2015.csv,2015,0.0019460981188105905,0.9980539018811894
1169,Love on the Cloud,45386560,271734,45114826,2014.csv,2014,0.005987102789900799,0.9940128972100992
1170,Tanhaji: The Unsung Warrior,45221814,0,45221814,2020.csv,2020,0.0,1.0
1171,Blair Witch,45173154,20777061,24396093,2016.csv,2016,0.4599426686035693,0.5400573313964308
1172,Flatliners,45158254,16883115,28275139,2017.csv,2017,0.3738655396198445,0.6261344603801555
1173,Boonie Bears: The Big Top Secret,45150390,0,45150390,2016.csv,2016,0.0,1.0
1174,Love Will Tear Us Apart,45060290,0,45060290,2021.csv,2021,0.0,1.0
1175,Grudge Match,44907260,29807260,15100000,2013.csv,2013,0.6637514735924659,0.3362485264075341
1176,Child's Play,44907074,29208403,15698671,2019.csv,2019,0.6504187513976083,0.3495812486023917
1177,Still Alice,44779195,18754371,26024824,2015.csv,2015,0.41881885103115407,0.5811811489688459
1178,The White Storm,44670277,0,44670277,2013.csv,2013,0.0,1.0
1179,Bad Genius,44560421,0,44560421,2017.csv,2017,0.0,1.0
1180,Mother!,44516999,17800004,26716995,2017.csv,2017,0.3998473482006278,0.6001526517993722
1181,Oculus,44446287,27695246,16751041,2014.csv,2014,0.6231172021185931,0.37688279788140683
1182,Detective Conan: The Eleventh Striker,44369456,0,44369456,2012.csv,2012,0.0,1.0
1183,Unhinged,44331465,20831465,23500000,2020.csv,2020,0.4699024722056896,0.5300975277943104
1184,House at the End of the Street,44287131,31611916,12675215,2012.csv,2012,0.7137946235442526,0.2862053764557474
1185,Tarzan,44095996,0,44095996,2013.csv,2013,0.0,1.0
1186,The Great Hypnotist,44077818,0,44077818,2014.csv,2014,0.0,1.0
1187,Winchester,44019588,25091816,18927772,2018.csv,2018,0.5700147852360635,0.4299852147639365
1188,Kick,43996483,2472695,41523788,2014.csv,2014,0.056202105972879696,0.9437978940271203
1189,Wind River,43980821,33800859,10179962,2017.csv,2017,0.7685363354176585,0.23146366458234147
1190,In the Heights,43975167,29975167,14000000,2021.csv,2021,0.681638502930529,0.31836149706947103
1191,Max,43967255,42656255,1311000,2015.csv,2015,0.9701823550276223,0.029817644972377738
1192,The End of Endless Love,43950000,0,43950000,2020.csv,2020,0.0,1.0
1193,Battle of Memories,43892362,594552,43297810,2017.csv,2017,0.01354568250393998,0.98645431749606
1194,Café Society,43763247,11103205,32660042,2016.csv,2016,0.25371072215002693,0.746289277849973
1195,Richard Jewell,43745542,22345542,21400000,2019.csv,2019,0.5108072955182497,0.4891927044817504
1196,The DUFF,43709744,34030343,9679401,2015.csv,2015,0.7785527867653491,0.22144721323465083
1197,League of Gods,43498766,181633,43317133,2016.csv,2016,0.004175589716728976,0.9958244102832711
1198,Secretly Greatly,43447199,0,43447199,2013.csv,2013,0.0,1.0
1199,Harriet,43347017,43082155,264862,2019.csv,2019,0.9938897294824232,0.006110270517576792
1200,The Snowman,43155261,6700035,36455226,2017.csv,2017,0.1552541878961177,0.8447458121038823
1201,A Shaun the Sheep Movie: Farmageddon,43100248,0,43100248,2019.csv,2019,0.0,1.0
1202,Annihilation,43070915,32732301,10338614,2018.csv,2018,0.7599629819798349,0.2400370180201651
1203,Gifted,43046590,24801212,18245378,2017.csv,2017,0.5761481223019059,0.42385187769809407
1204,The Possession of Hannah Grace,43016528,14837422,28179106,2018.csv,2018,0.3449237465190124,0.6550762534809876
1205,Legend,42972994,1872994,41100000,2015.csv,2015,0.04358537364187378,0.9564146263581262
1206,"The Chef, The Actor, The Scoundrel",42970000,0,42970000,2013.csv,2013,0.0,1.0
1207,The Gallows,42964410,22764410,20200000,2015.csv,2015,0.5298434215668271,0.47015657843317293
1208,Asterix and Obelix: Mansion of the Gods,42830578,0,42830578,2014.csv,2014,0.0,1.0
1209,Doraemon: Nobita's Secret Gadget Museum,42770271,0,42770271,2013.csv,2013,0.0,1.0
1210,Belfast,42768240,9137240,33631000,2021.csv,2021,0.21364545279394243,0.7863545472060576
1211,Spirit Untamed,42717215,17716215,25001000,2021.csv,2021,0.4147324445191476,0.5852675554808524
1212,Peninsula,42698327,1231407,41466920,2020.csv,2020,0.02883970137752704,0.971160298622473
1213,Almost Christmas,42580920,42158780,422140,2016.csv,2016,0.9900861700498721,0.009913829950127897
1214,Thermae Romae II,42473163,0,42473163,2014.csv,2014,0.0,1.0
1215,Love the Coopers,42426912,26302731,16124181,2015.csv,2015,0.6199539339558816,0.3800460660441184
1216,Loving Vincent,42187665,6735118,35452547,2017.csv,2017,0.15964661708582353,0.8403533829141765
1217,The Throne,42165755,0,42165755,2015.csv,2015,0.0,1.0
1218,Monster Hunter,42145959,15162470,26983489,2020.csv,2020,0.3597609441037989,0.6402390558962011
1219,Long Day's Journey Into Night,42140994,521365,41619629,2018.csv,2018,0.01237191984602926,0.9876280801539707
1220,Jobs,42128352,16131410,25996942,2013.csv,2013,0.3829110144161348,0.6170889855838653
1221,Bang Bang,42045981,2546172,39499809,2014.csv,2014,0.060556846087144456,0.9394431539128556
1222,Detective Conan: The Sniper from Another Dimension,42028116,0,42028116,2014.csv,2014,0.0,1.0
1223,Mary and the Witch's Flower,41978431,2418404,39560027,2017.csv,2017,0.05761063342267366,0.9423893665773263
1224,Rurouni Kenshin: The Legend Ends,41900000,0,41900000,2014.csv,2014,0.0,1.0
1225,"As Above, So Below",41898409,21321100,20577309,2014.csv,2014,0.5088761246280259,0.49112387537197416
1226,Call Me by Your Name,41887595,18095701,23791894,2017.csv,2017,0.4320062061333433,0.5679937938666567
1227,The Guilt Trip,41863726,37134215,4729511,2012.csv,2012,0.8870260377683534,0.11297396223164656
1228,No Man's Land,41807712,0,41807712,2013.csv,2013,0.0,1.0
1229,T2 Trainspotting,41681746,2402004,39279742,2017.csv,2017,0.05762724047116452,0.9423727595288355
1230,Overlord,41657844,21704844,19953000,2018.csv,2018,0.5210265802522089,0.47897341974779106
1231,Safe,41564670,17142080,24422590,2012.csv,2012,0.4124194899177595,0.5875805100822405
1232,The Great Battle,41509280,472166,41037114,2018.csv,2018,0.0113749503725432,0.9886250496274568
1233,Lupin III vs. Detective Conan: The Movie,41397727,0,41397727,2013.csv,2013,0.0,1.0
1234,The Lady in the Van,41387687,10021175,31366512,2015.csv,2015,0.24212938017048405,0.757870619829516
1235,Ricki and the Flash,41325328,26822144,14503184,2015.csv,2015,0.6490485447568619,0.35095145524313803
1236,This Is Where I Leave You,41296320,34296320,7000000,2014.csv,2014,0.8304933708378858,0.1695066291621142
1237,Moonfall,41248335,19060660,22187675,2022.csv,2022,0.4620952579055615,0.5379047420944385
1238,The Darkest Minds,41142379,12695691,28446688,2018.csv,2018,0.30857940908084097,0.6914205909191591
1239,Fist Fight,41087017,32187017,8900000,2017.csv,2017,0.7833865622320549,0.21661343776794503
1240,"Lost, Found",41043552,0,41043552,2018.csv,2018,0.0,1.0
1241,Dredd,41037742,13414714,27623028,2012.csv,2012,0.32688723468264896,0.6731127653173511
1242,La vérité si je mens! 3,40928635,0,40928635,2012.csv,2012,0.0,1.0
1243,Always: Sunset on Third Street '64,40923305,0,40923305,2012.csv,2012,0.0,1.0
1244,Underwater,40882928,17291078,23591850,2020.csv,2020,0.4229412824834855,0.5770587175165145
1245,Fighting with My Family,40812363,22958886,17853477,2019.csv,2019,0.5625473340026893,0.43745266599731064
1246,The War with Grandpa,40709936,21277892,19432044,2020.csv,2020,0.5226707308014437,0.47732926919855634
1247,The Circle,40656399,20497844,20158555,2017.csv,2017,0.504172639588666,0.495827360411334
1248,Spiral,40618920,23216862,17402058,2021.csv,2021,0.571577530864927,0.42842246913507304
1249,Spanish Affair 2,40591862,0,40591862,2015.csv,2015,0.0,1.0
1250,Holmes & Watson,40466970,30573626,9893344,2018.csv,2018,0.7555205146320567,0.24447948536794328
1251,The Witch,40423945,25138705,15285240,2016.csv,2016,0.6218765882449128,0.37812341175508724
1252,Masquerade Hotel,40396244,0,40396244,2019.csv,2019,0.0,1.0
1253,Carol,40272135,12711491,27560644,2015.csv,2015,0.3156398586764769,0.6843601413235231
1254,Yolki 3,40267368,0,40267368,2013.csv,2013,0.0,1.0
1255,Boonie Bears: To the Rescue,40163675,0,40163675,2014.csv,2014,0.0,1.0
1256,Diary of a Wimpy Kid: The Long Haul,40140972,20738724,19402248,2017.csv,2017,0.5166472799911273,0.48335272000887275
1257,The Wild Life,40075446,8005586,32069860,2016.csv,2016,0.19976286726790266,0.8002371327320974
1258,Snake Eyes,40064325,28264325,11800000,2021.csv,2021,0.7054736352103773,0.2945263647896227
1259,Northern Limit Line,40034677,337907,39696770,2015.csv,2015,0.008440357842777151,0.9915596421572228
1260,Love O2O,39969537,0,39969537,2016.csv,2016,0.0,1.0
1261,Brotherhood of Blades 2,39966092,14204,39951888,2017.csv,2017,0.0003554012736596813,0.9996445987263404
1262,The Last Wish,39756292,0,39756292,2019.csv,2019,0.0,1.0
1263,Midnight Runners,39730433,0,39730433,2017.csv,2017,0.0,1.0
1264,The Forest,39712000,26594261,13117739,2016.csv,2016,0.6696782080983078,0.3303217919016922
1265,Tokyo Revengers,39687069,0,39687069,2021.csv,2021,0.0,1.0
1266,The November Man,39661919,25018119,14643800,2014.csv,2014,0.6307843803523475,0.3692156196476524
1267,Intimate Strangers,39576060,0,39576060,2018.csv,2018,0.0,1.0
1268,Thugs of Hindostan,39570044,1449848,38120196,2018.csv,2018,0.0366400401273246,0.9633599598726754
1269,Recep Ivedik 4,39477906,0,39477906,2014.csv,2014,0.0,1.0
1270,Nomadland,39458207,3700000,35758207,2021.csv,2021,0.09377009958916785,0.9062299004108322
1271,Don Jon,39439355,24477704,14961651,2013.csv,2013,0.6206415901071405,0.37935840989285957
1272,Sin City: A Dame to Kill For,39407616,13757804,25649812,2014.csv,2014,0.3491153588179503,0.6508846411820497
1273,Uri: The Surgical Strike,39346577,4186168,35160409,2019.csv,2019,0.10639217739322025,0.8936078226067797
1274,The Gambler,39280992,33680992,5600000,2014.csv,2014,0.8574374089126874,0.14256259108731267
1275,Absolutely Fabulous: The Movie,39219109,4772155,34446954,2016.csv,2016,0.12167933238870877,0.8783206676112912
1276,My Mom Is a Character 2,39195565,0,39195565,2016.csv,2016,0.0,1.0
1277,Sink or Swim,39193850,0,39193850,2018.csv,2018,0.0,1.0
1278,Samba,39178695,151530,39027165,2014.csv,2014,0.0038676632797493638,0.9961323367202506
1279,Show Dogs,39156854,17857020,21299834,2018.csv,2018,0.4560381689499366,0.5439618310500635
1280,Women Who Flirt,39156132,375495,38780637,2014.csv,2014,0.009589685722787941,0.990410314277212
1281,Masterpiece Mystery: Sherlock: The Abominable Bride,39139204,0,39139204,2016.csv,2016,0.0,1.0
1282,Ex-Files 2: The Backup Strikes Back,39108291,0,39108291,2015.csv,2015,0.0,1.0
1283,Believer,39047153,365639,38681514,2018.csv,2018,0.009364037372968011,0.990635962627032
1284,Forbidden Empire 2014 Re-release,38885962,0,38885962,2014.csv,2014,0.0,1.0
1285,The Spy Gone North,38844509,500803,38343706,2018.csv,2018,0.012892504317663018,0.987107495682337
1286,Criminal,38803993,14708696,24095297,2015.csv,2015,0.3790510940459143,0.6209489059540857
1287,Antoine and Sebastian,38719881,0,38719881,2013.csv,2013,0.0,1.0
1288,On the Basis of Sex,38673750,24622687,14051063,2018.csv,2018,0.6366769966708685,0.36332300332913153
1289,"Crouching Tiger, Hidden Dragon: Sword of Destiny",38659039,0,38659039,2016.csv,2016,0.0,1.0
1290,The Best of Me,38609668,26766213,11843455,2014.csv,2014,0.6932515710831805,0.30674842891681947
1291,Resident Evil: Welcome to Raccoon City,38600612,17000612,21600000,2021.csv,2021,0.44042337981584334,0.5595766201841567
1292,Taxi 5,38598227,0,38598227,2018.csv,2018,0.0,1.0
1293,Million Dollar Arm,38483455,36457627,2025828,2014.csv,2014,0.9473584687237672,0.05264153127623286
1294,Chernobyl Diaries,38390020,18119640,20270380,2012.csv,2012,0.4719882927906784,0.5280117072093216
1295,Boruto: Naruto The Movie,38362448,919651,37442797,2015.csv,2015,0.023972688082887723,0.9760273119171122
1296,The Lazarus Effect,38356892,25801570,12555322,2015.csv,2015,0.6726710287162996,0.3273289712837005
1297,The Water Diviner,38176317,4196641,33979676,2014.csv,2014,0.10992786444014492,0.8900721355598551
1298,King Richard,38083946,15083946,23000000,2021.csv,2021,0.39607098487115805,0.603929015128842
1299,Arashi Anniversary Tour 5 x 20 Film: Record of Memories,38052695,0,38052695,2021.csv,2021,0.0,1.0
1300,But Always,38039248,430760,37608488,2014.csv,2014,0.011324093473141214,0.9886759065268588
1301,Nightmare Alley,38034700,11322374,26712326,2021.csv,2021,0.2976853767743666,0.7023146232256334
1302,Overcomer,38026103,34746945,3279158,2019.csv,2019,0.9137656046426845,0.08623439535731547
1303,Helios,37938005,0,37938005,2015.csv,2015,0.0,1.0
1304,Killing Them Softly,37930465,15026056,22904409,2012.csv,2012,0.39614742397700636,0.6038525760229937
1305,The King,37886707,0,37886707,2017.csv,2017,0.0,1.0
1306,Hell or High Water,37879877,27007844,10872033,2016.csv,2016,0.7129865812394269,0.28701341876057307
1307,Cold Eyes,37795598,0,37795598,2013.csv,2013,0.0,1.0
1308,Mission Milano,37749848,0,37749848,2016.csv,2016,0.0,1.0
1309,The Handmaiden,37692886,2006788,35686098,2016.csv,2016,0.05324049742436809,0.9467595025756319
1310,The Yinyang Master,37690000,0,37690000,2021.csv,2021,0.0,1.0
1311,Rurouni Kenshin Part I: Origins,37654579,0,37654579,2012.csv,2012,0.0,1.0
1312,Pokémon the Movie: I Choose You!,37552144,2401722,35150422,2017.csv,2017,0.06395698738266449,0.9360430126173355
1313,Fat Buddies,37496410,0,37496410,2018.csv,2018,0.0,1.0
1314,A Walk in the Woods,37461274,29504281,7956993,2015.csv,2015,0.7875941699153104,0.21240583008468958
1315,Sarileru Neekevvaru,37389889,821000,36568889,2020.csv,2020,0.021957807898279665,0.9780421921017204
1316,Pain and Glory,37359689,4567338,32792351,2019.csv,2019,0.12225310547954508,0.877746894520455
1317,Snowden,37357216,21587519,15769697,2016.csv,2016,0.5778674460109662,0.4221325539890339
1318,Home Again,37270721,27020284,10250437,2017.csv,2017,0.7249734718037786,0.27502652819622136
1319,"Like Father, Like Son",37170163,334616,36835547,2013.csv,2013,0.009002274216553745,0.9909977257834462
1320,A Witness Out of the Blue,37092694,0,37092694,2019.csv,2019,0.0,1.0
1321,Till The End Of The World,37013733,118660,36895073,2018.csv,2018,0.003205837141582018,0.9967941628584179
1322,Rurouni Kenshin: Final Chapter Part I - The Final,36964978,0,36964978,2021.csv,2021,0.0,1.0
1323,2.0,36945969,4152000,32793969,2018.csv,2018,0.11238032490093845,0.8876196750990616
1324,Devil's Due,36921560,15821461,21100099,2014.csv,2014,0.42851550692874296,0.571484493071257
1325,Ex Machina,36869414,25442958,11426456,2015.csv,2015,0.6900830590906598,0.3099169409093402
1326,The Adventurers,36796816,216556,36580260,2017.csv,2017,0.0058851831093211975,0.9941148168906788
1327,New Interpretation Records of the Three Kingdoms,36747486,0,36747486,2020.csv,2020,0.0,1.0
1328,Burnt,36606743,13651946,22954797,2015.csv,2015,0.3729352813496683,0.6270647186503318
1329,The Intruder,36599361,35419122,1180239,2019.csv,2019,0.9677524697767265,0.03224753022327357
1330,The Priests,36577134,185093,36392041,2015.csv,2015,0.005060347265042691,0.9949396527349573
1331,The Tower,36512327,0,36512327,2012.csv,2012,0.0,1.0
1332,Detective Conan: Private Eye in the Distant Sea,36324232,0,36324232,2013.csv,2013,0.0,1.0
1333,A Most Wanted Man,36233517,17237855,18995662,2014.csv,2014,0.4757433566275115,0.5242566433724886
1334,Nobunaga Concerto: The Movie,36187594,0,36187594,2016.csv,2016,0.0,1.0
1335,Dügün Dernek,36185741,0,36185741,2013.csv,2013,0.0,1.0
1336,The Confidence Man JP: Princess,36109913,0,36109913,2020.csv,2020,0.0,1.0
1337,The Door Lock,36100000,0,36100000,2021.csv,2021,0.0,1.0
1338,Nothing to Lose,36075317,1016188,35059129,2018.csv,2018,0.028168512005036575,0.9718314879949634
1339,T-34,35950901,0,35950901,2018.csv,2018,0.0,1.0
1340,Kundo: Age of the Rampant,35941291,280958,35660333,2014.csv,2014,0.00781713711953196,0.9921828628804681
1341,Doraemon the Movie: The New Records of Nobita's Spaceblazer 2014 Re-release,35861856,0,35861856,2014.csv,2014,0.0,1.0
1342,Conquest 1453,35797045,35730,35761315,2012.csv,2012,0.0009981270800425008,0.9990018729199575
1343,The New Adventures of Aladdin,35771820,0,35771820,2015.csv,2015,0.0,1.0
1344,Heidi,35755670,0,35755670,2015.csv,2015,0.0,1.0
1345,"Tad, the Lost Explorer, and the Secret of King Midas",35704046,5874,35698172,2017.csv,2017,0.00016451916962016014,0.9998354808303799
1346,Hostiles,35669017,29819114,5849903,2017.csv,2017,0.835994835517895,0.164005164482105
1347,The Terror Live,35659824,0,35659824,2013.csv,2013,0.0,1.0
1348,Good Deeds,35579177,35025791,553386,2012.csv,2012,0.9844463518647438,0.015553648135256191
1349,The Queen's Corgi,35515687,0,35515687,2019.csv,2019,0.0,1.0
1350,Mia and the White Lion,35487190,399471,35087719,2018.csv,2018,0.011256766173934877,0.9887432338260651
1351,Arbitrage,35485056,7919574,27565482,2012.csv,2012,0.22318054112694652,0.7768194588730535
1352,Hide and Seek,35461505,0,35461505,2013.csv,2013,0.0,1.0
1353,Room,35401758,14677654,20724104,2015.csv,2015,0.4146024047732319,0.5853975952267682
1354,Namiya,35351623,70814,35280809,2017.csv,2017,0.0020031329254670996,0.997996867074533
1355,Eye in the Sky,35259653,18704595,16555058,2016.csv,2016,0.5304815393390286,0.46951846066097136
1356,Les Tuche 2: The American Dream,35210425,0,35210425,2016.csv,2016,0.0,1.0
1357,Destiny: The Tale of Kamakura,35166640,0,35166640,2017.csv,2017,0.0,1.0
1358,The Girl in the Spider's Web,35164920,14841338,20323582,2018.csv,2018,0.42204953118050603,0.577950468819494
1359,The Liquidator,35046130,0,35046130,2017.csv,2017,0.0,1.0
1360,Welcome to the North,34995189,0,34995189,2012.csv,2012,0.0,1.0
1361,I Fell in Love Like a Flower Bouquet,34975905,0,34975905,2021.csv,2021,0.0,1.0
1362,Blind Detective,34958596,0,34958596,2013.csv,2013,0.0,1.0
1363,When Marnie Was There,34949567,561085,34388482,2014.csv,2014,0.016054133088401354,0.9839458669115987
1364,The Hate U Give,34934009,29719483,5214526,2018.csv,2018,0.8507321046376326,0.14926789536236737
1365,Lost and Love,34930177,188817,34741360,2015.csv,2015,0.005405555202311171,0.9945944447976889
1366,Secret in Their Eyes,34854990,20180155,14674835,2015.csv,2015,0.578974631752871,0.42102536824712905
1367,"Dad, Where Are We Going 2",34840000,0,34840000,2015.csv,2015,0.0,1.0
1368,Chimpanzee,34823764,28972764,5851000,2012.csv,2012,0.8319825507661952,0.16801744923380482
1369,Kidnap,34814102,30971040,3843062,2017.csv,2017,0.8896119164584513,0.11038808354154876
1370,Doraemon: Nobita and the Space Heroes,34811747,0,34811747,2015.csv,2015,0.0,1.0
1371,Broken City,34737199,19701164,15036035,2013.csv,2013,0.5671488941868917,0.4328511058131083
1372,Endless Love,34718173,23438250,11279923,2014.csv,2014,0.6751003285800782,0.32489967141992177
1373,The Man Standing Next,34664900,113527,34551373,2020.csv,2020,0.003274984205925879,0.9967250157940741
1374,Alex Cross,34618867,25888412,8730455,2012.csv,2012,0.7478122262060165,0.2521877737939835
1375,R.A.I.D. Special Unit,34598750,0,34598750,2017.csv,2017,0.0,1.0
1376,Salmon Fishing in the Yemen,34564651,9047981,25516670,2012.csv,2012,0.2617697774526929,0.7382302225473071
1377,Haywire,34513760,18942396,15571364,2012.csv,2012,0.548836058430029,0.4511639415699709
1378,Steve Jobs,34441873,17766658,16675215,2015.csv,2015,0.515844710303647,0.484155289696353
1379,Adventures in Zambezia,34428345,0,34428345,2012.csv,2012,0.0,1.0
1380,My Mom is a Character 3,34360029,0,34360029,2020.csv,2020,0.0,1.0
1381,Warrior of the Hornor,34291831,0,34291831,2019.csv,2019,0.0,1.0
1382,Victor Frankenstein,34227298,5775076,28452222,2015.csv,2015,0.16872719546836562,0.8312728045316343
1383,The House,34184504,25584504,8600000,2017.csv,2017,0.748424022767743,0.25157597723225705
1384,Cirque du Soleil: Worlds Away,34153101,12512862,21640239,2012.csv,2012,0.36637557450493297,0.633624425495067
1385,The Battle: Roar to Victory,34148707,0,34148707,2019.csv,2019,0.0,1.0
1386,Black & White: The Dawn of Justice,34146896,0,34146896,2014.csv,2014,0.0,1.0
1387,The Bad Guys: The Movie,34024386,166972,33857414,2019.csv,2019,0.004907421400638942,0.9950925785993611
1388,"My Love, Don't Cross That River",34012261,0,34012261,2014.csv,2014,0.0,1.0
1389,Malignant,33991791,13391791,20600000,2021.csv,2021,0.39397132678298713,0.6060286732170129
1390,The Witness,33963557,418063,33545494,2015.csv,2015,0.012309164202088727,0.9876908357979113
1391,Doraemon the Movie: Nobita's New Dinosaur,33942341,0,33942341,2020.csv,2020,0.0,1.0
1392,The Good Liar,33856058,17156058,16700000,2019.csv,2019,0.5067352495674482,0.49326475043255186
1393,Don't Go Breaking My Heart 2,33801759,0,33801759,2014.csv,2014,0.0,1.0
1394,The Art of Racing in the Rain,33766787,26395642,7371145,2019.csv,2019,0.7817042823766442,0.21829571762335576
1395,I Want to Eat Your Pancreas,33748006,277019,33470987,2017.csv,2017,0.008208455338072419,0.9917915446619275
1396,Deliver Us from Evil,33718703,0,33718703,2020.csv,2020,0.0,1.0
1397,Nobody's Fool,33705333,31713110,1992223,2018.csv,2018,0.9408929441521909,0.05910705584780901
1398,Three Heroes on Distant Shores,33674759,0,33674759,2012.csv,2012,0.0,1.0
1399,Bloodshot,33542457,12561824,20980633,2020.csv,2020,0.37450518308781017,0.6254948169121898
1400,2016: Obama's America,33449086,33449086,0,2012.csv,2012,1.0,0.0
1401,Get on Up,33448971,30703100,2745871,2014.csv,2014,0.9179086555457865,0.08209134445421355
1402,The Perks of Being a Wallflower,33384127,17742948,15641179,2012.csv,2012,0.5314785676438386,0.46852143235616134
1403,Girls,33325338,0,33325338,2014.csv,2014,0.0,1.0
1404,Perfect Strangers,33262366,1014507,32247859,2017.csv,2017,0.03050014541960124,0.9694998545803988
1405,Project Almanac,33213241,22348241,10865000,2015.csv,2015,0.6728714310054836,0.32712856899451637
1406,Bharat,33185983,2971549,30214434,2019.csv,2019,0.08954229259986062,0.9104577074001394
1407,Baaghi 2,33139063,1319579,31819484,2018.csv,2018,0.039819442088631175,0.9601805579113688
1408,Lockout,32948113,14326864,18621249,2012.csv,2012,0.43483109336185655,0.5651689066381435
1409,Inside Llewyn Davis,32935319,13235319,19700000,2013.csv,2013,0.40185792644060925,0.5981420735593908
1410,Sleepless,32917353,20783704,12133649,2017.csv,2017,0.6313905009312262,0.3686094990687738
1411,Brightburn,32893421,17300439,15592982,2019.csv,2019,0.5259543846169117,0.4740456153830883
1412,Serial Teachers,32849727,0,32849727,2013.csv,2013,0.0,1.0
1413,Hindi Medium,32841493,0,32841493,2017.csv,2017,0.0,1.0
1414,Bait,32813407,0,32813407,2012.csv,2012,0.0,1.0
1415,The Crossing,32806475,0,32806475,2014.csv,2014,0.0,1.0
1416,Fly Me to the Saitama,32802347,0,32802347,2019.csv,2019,0.0,1.0
1417,Old Boys: The Way of the Dragon,32800000,0,32800000,2014.csv,2014,0.0,1.0
1418,Big Red Envelope,32800000,0,32800000,2021.csv,2021,0.0,1.0
1419,Steel Rain,32783733,0,32783733,2017.csv,2017,0.0,1.0
1420,Part of Me,32726956,25326071,7400885,2012.csv,2012,0.7738596586862524,0.2261403413137476
1421,Mud,32613173,21590086,11023087,2013.csv,2013,0.6620050738393348,0.3379949261606652
1422,BTS Permission to Dance on Stage - Seoul: Live Viewing,32600000,6840000,25760000,2022.csv,2022,0.2098159509202454,0.7901840490797546
1423,The Hurricane Heist,32517248,6115825,26401423,2018.csv,2018,0.18807941557661953,0.8119205844233804
1424,Midsummer's Equation,32514549,0,32514549,2013.csv,2013,0.0,1.0
1425,Nameless Gangster: Rules of the Time,32472645,0,32472645,2012.csv,2012,0.0,1.0
1426,UglyDolls,32450241,20150241,12300000,2019.csv,2019,0.6209581309426947,0.3790418690573053
1427,Movie 43,32438988,8840453,23598535,2012.csv,2012,0.2725255485775327,0.7274744514224674
1428,The House That Never Dies II,32433588,0,32433588,2017.csv,2017,0.0,1.0
1429,Stuber,32390945,22370452,10020493,2019.csv,2019,0.6906390659488323,0.3093609340511677
1430,Hit Me Anyone One More Time!,32333512,0,32333512,2019.csv,2019,0.0,1.0
1431,Kevin Hart: Let Me Explain,32318051,32244051,74000,2013.csv,2013,0.997710257960791,0.002289742039208986
1432,Pokémon,32293377,0,32293377,2013.csv,2013,0.0,1.0
1433,Masquerade Night,32287400,0,32287400,2021.csv,2021,0.0,1.0
1434,Seven Psychopaths,32226382,15024049,17202333,2012.csv,2012,0.4662034044032619,0.5337965955967381
1435,Somewhere Winter,32218990,0,32218990,2019.csv,2019,0.0,1.0
1436,Once Upon a Time in Hong Kong,32218874,0,32218874,2021.csv,2021,0.0,1.0
1437,Home Sweet Home,32178677,0,32178677,2021.csv,2021,0.0,1.0
1438,The After-Dinner Mysteries,32160741,0,32160741,2013.csv,2013,0.0,1.0
1439,The Kid Who Would Be King,32140970,16790790,15350180,2019.csv,2019,0.5224108046521309,0.4775891953478691
1440,Respect,32104126,24278399,7825727,2021.csv,2021,0.7562392136138514,0.24376078638614862
1441,Two Tigers,32001580,0,32001580,2019.csv,2019,0.0,1.0
1442,Os Dez Mandamentos - O Filme,31998251,0,31998251,2016.csv,2016,0.0,1.0
1443,Dilwale,31994323,4871263,27123060,2015.csv,2015,0.15225397955756087,0.8477460204424391
1444,Suffragette,31972096,4702420,27269676,2015.csv,2015,0.1470788777814254,0.8529211222185746
1445,The Floating Castle,31967471,0,31967471,2012.csv,2012,0.0,1.0
1446,The Neighbors,31949315,0,31949315,2012.csv,2012,0.0,1.0
1447,All About Me,31920159,0,31920159,2018.csv,2018,0.0,1.0
1448,Bounty Hunters,31918573,0,31918573,2016.csv,2016,0.0,1.0
1449,Bad Times at the El Royale,31882724,17839115,14043609,2018.csv,2018,0.5595229253309724,0.44047707466902764
1450,Tinker Bell and the Legend of the NeverBeast,31836701,0,31836701,2014.csv,2014,0.0,1.0
1451,The Dream Team,31822402,0,31822402,2012.csv,2012,0.0,1.0
1452,Self/less,31807156,12279691,19527465,2015.csv,2015,0.38606692783221486,0.6139330721677851
1453,Underdogs,31775719,0,31775719,2013.csv,2013,0.0,1.0
1454,Spring Breakers,31724284,14124284,17600000,2013.csv,2013,0.44521994570468476,0.5547800542953152
1455,Hunter Killer,31672678,15767460,15905218,2018.csv,2018,0.49782528651350544,0.5021747134864946
1456,New World,31670607,457806,31212801,2013.csv,2013,0.014455232891494628,0.9855447671085054
1457,Ae Dil Hai Mushkil,31668920,4264983,27403937,2016.csv,2016,0.1346740905594507,0.8653259094405493
1458,Anna,31626978,7743794,23883184,2019.csv,2019,0.2448477372703772,0.7551522627296228
1459,Super Troopers 2,31626386,30617396,1008990,2018.csv,2018,0.9680965760678442,0.03190342393215589
1460,The Four 3,31521335,0,31521335,2014.csv,2014,0.0,1.0
1461,Harry Potter and the Sorcerer's Stone 2020 Re-release,31501815,0,31501815,2020.csv,2020,0.0,1.0
1462,Son of a Rich,31421448,0,31421448,2019.csv,2019,0.0,1.0
1463,Assassination Classroom: The Graduation,31352921,0,31352921,2016.csv,2016,0.0,1.0
1464,What's in a Name?,31303580,8111,31295469,2012.csv,2012,0.00025910774422605975,0.9997408922557739
1465,101 Proposals,31283838,0,31283838,2013.csv,2013,0.0,1.0
1466,Tazza: The Hidden Card,31278476,251555,31026921,2014.csv,2014,0.008042431479078457,0.9919575685209215
1467,Perfect Strangers,31254929,0,31254929,2016.csv,2016,0.0,1.0
1468,Saving Mr. Wu,31222161,92696,31129465,2015.csv,2015,0.0029689168536412326,0.9970310831463588
1469,Honest Thief,31220247,14163574,17056673,2020.csv,2020,0.4536663018713465,0.5463336981286535
1470,The Invisible Guest,31191910,0,31191910,2017.csv,2017,0.0,1.0
1471,My Dear Liar,31177968,90545,31087423,2019.csv,2019,0.0029041340987969455,0.997095865901203
1472,Joyful Noise,31158113,30932113,226000,2012.csv,2012,0.9927466724316714,0.007253327568328673
1473,Mrs. Brown's Boys D'Movie,31116264,0,31116264,2014.csv,2014,0.0,1.0
1474,Premium Rush,31083599,20275446,10808153,2012.csv,2012,0.6522875938529512,0.3477124061470488
1475,The Wild Goose Lake,31064835,12573,31052262,2019.csv,2019,0.0004047341632427792,0.9995952658367572
1476,The Strangers: Prey at Night,31039126,24586708,6452418,2018.csv,2018,0.7921198554366512,0.20788014456334886
1477,This Is Not What I Expected,30996615,337670,30658945,2017.csv,2017,0.010893770174581966,0.9891062298254181
1478,Playing for Keeps,30962335,13103272,17859063,2012.csv,2012,0.42320038201253235,0.5767996179874677
1479,Rise of the Legend,30932534,0,30932534,2014.csv,2014,0.0,1.0
1480,Billy Lynn's Long Halftime Walk,30930984,1738477,29192507,2016.csv,2016,0.05620503376161586,0.9437949662383841
1481,Pandora,30896701,0,30896701,2016.csv,2016,0.0,1.0
1482,Gintama 2: Rules are Made to be Broken,30896653,0,30896653,2018.csv,2018,0.0,1.0
1483,The Unholy,30832137,15532137,15300000,2021.csv,2021,0.5037645298475418,0.4962354701524581
1484,Attack on Titan Part 1,30810658,449523,30361135,2015.csv,2015,0.014589853939503662,0.9854101460604964
1485,Winter's Tale,30800231,12600231,18200000,2014.csv,2014,0.40909534087585253,0.5909046591241475
1486,Norm of the North,30734502,17062499,13672003,2016.csv,2016,0.5551578157993254,0.44484218420067456
1487,A Man Called Ove,30692889,3479315,27213574,2015.csv,2015,0.11335899334858963,0.8866410066514103
1488,A Wedding Invitation,30665036,14350,30650686,2013.csv,2013,0.0004679596658552757,0.9995320403341448
1489,When the Bough Breaks,30658387,29747603,910784,2016.csv,2016,0.9702925010373181,0.02970749896268189
1490,Wild Tales,30642704,3106530,27536174,2014.csv,2014,0.10137910805782675,0.8986208919421732
1491,The Last Warrior,30618274,0,30618274,2017.csv,2017,0.0,1.0
1492,The Last Duel,30552111,10853945,19698166,2021.csv,2021,0.35526006697213164,0.6447399330278684
1493,The Four,30505808,0,30505808,2012.csv,2012,0.0,1.0
1494,Licorice Pizza,30487210,17094694,13392516,2021.csv,2021,0.560716903908229,0.43928309609177096
1495,Like a Boss,30399490,22169514,8229976,2020.csv,2020,0.7292725634541896,0.2707274365458105
1496,S Storm,30381402,0,30381402,2016.csv,2016,0.0,1.0
1497,The Way of the Bug,30355804,0,30355804,2018.csv,2018,0.0,1.0
1498,Nocturnal Animals,30311857,10663357,19648500,2016.csv,2016,0.3517883117487655,0.6482116882512345
1499,Far from the Madding Crowd,30229977,12236500,17993477,2015.csv,2015,0.40478032781831097,0.595219672181689
1500,The Grand Heist,30158762,0,30158762,2012.csv,2012,0.0,1.0
1501,A Silent Voice: The Movie,30156463,310407,29846056,2016.csv,2016,0.010293216415996797,0.9897067835840032
1502,When the Game Stands Tall,30138754,30127963,10791,2014.csv,2014,0.9996419560012335,0.0003580439987665051
1503,Clergy,30114115,0,30114115,2018.csv,2018,0.0,1.0
1504,My Hero Academia: Heroes Rising,29971229,13304000,16667229,2019.csv,2019,0.4438923742499849,0.5561076257500152
1505,Reset 2017 Re-release,29949252,108970,29840282,2017.csv,2017,0.0036384881999724067,0.9963615118000276
1506,The Little Things,29942746,15342746,14600000,2021.csv,2021,0.5124027702736416,0.48759722972635844
1507,Keeping Up with the Joneses,29918745,14904426,15014319,2016.csv,2016,0.4981634757741342,0.5018365242258658
1508,The Bye Bye Man,29874280,22395806,7478474,2017.csv,2017,0.7496684773658143,0.2503315226341857
1509,Escape from Mogadishu,29861163,346271,29514892,2021.csv,2021,0.011596031942895192,0.9884039680571048
1510,Draft Day,29824199,28842237,981962,2014.csv,2014,0.9670749916871195,0.03292500831288042
1511,The Disaster Artist,29820616,21120616,8700000,2017.csv,2017,0.7082555236283516,0.2917444763716484
1512,Ice,29806210,0,29806210,2018.csv,2018,0.0,1.0
1513,Jackie,29777777,13960394,15817383,2016.csv,2016,0.46881921373781527,0.5311807862621847
1514,The Swindlers,29721916,241916,29480000,2017.csv,2017,0.008139313764294335,0.9918606862357057
1515,The Raven,29699345,16008272,13691073,2012.csv,2012,0.5390109445174632,0.4609890554825367
1516,Masterminds,29674699,17368022,12306677,2016.csv,2016,0.5852804774868988,0.4147195225131011
1517,Amour,29652180,6739492,22912688,2012.csv,2012,0.22728487416439533,0.7727151258356046
1518,Free Solo,29390279,17541090,11849189,2018.csv,2018,0.5968330549022689,0.4031669450977311
1519,All About My Wife,29382038,0,29382038,2012.csv,2012,0.0,1.0
1520,Alibi.com,29370592,0,29370592,2017.csv,2017,0.0,1.0
1521,Mr. Holmes,29355203,17737646,11617557,2015.csv,2015,0.6042419805443008,0.3957580194556992
1522,Rowdy Rathore,29342463,777373,28565090,2012.csv,2012,0.02649310659435781,0.9735068934056422
1523,Sword Art Online the Movie: Ordinal Scale,29322339,1522976,27799363,2017.csv,2017,0.05193910349375607,0.9480608965062439
1524,Silent Witness,29315945,0,29315945,2013.csv,2013,0.0,1.0
1525,Big Eyes,29253166,14482031,14771135,2014.csv,2014,0.495058586137309,0.504941413862691
1526,Fall In Love At First Kiss,29206238,0,29206238,2019.csv,2019,0.0,1.0
1527,Dark Figure of Crime,29176133,0,29176133,2018.csv,2018,0.0,1.0
1528,Flight Crew,29171110,0,29171110,2016.csv,2016,0.0,1.0
1529,Viking,29161298,0,29161298,2016.csv,2016,0.0,1.0
1530,Special ID,29139936,12666,29127270,2013.csv,2013,0.0004346612154535961,0.9995653387845465
1531,The Fatal Encounter,29060186,0,29060186,2014.csv,2014,0.0,1.0
1532,Pad Man,29045020,1670192,27374828,2018.csv,2018,0.057503558269197265,0.9424964417308027
1533,SPEC: Heaven,29023960,0,29023960,2012.csv,2012,0.0,1.0
1534,Recep Ivedik 5,28952258,0,28952258,2017.csv,2017,0.0,1.0
1535,M.S. Dhoni: The Untold Story,28903047,1801550,27101497,2016.csv,2016,0.06233079854867897,0.937669201451321
1536,We Were There: True Love,28876929,0,28876929,2012.csv,2012,0.0,1.0
1537,Kokowääh 2,28811936,0,28811936,2013.csv,2013,0.0,1.0
1538,Bol Bachchan,28775262,1216258,27559004,2012.csv,2012,0.04226748656536993,0.9577325134346301
1539,Mirai,28756961,812794,27944167,2018.csv,2018,0.028264252262260953,0.9717357477377391
1540,Judwaa 2,28733523,1431255,27302268,2017.csv,2017,0.04981133013170713,0.9501886698682929
1541,Bath Buddy,28700000,0,28700000,2020.csv,2020,0.0,1.0
1542,Master,28692230,0,28692230,2021.csv,2021,0.0,1.0
1543,The Suspect,28674130,218693,28455437,2013.csv,2013,0.007626839942484741,0.9923731600575153
1544,The Fortress,28645448,252895,28392553,2017.csv,2017,0.008828453302598025,0.9911715466974019
1545,Love & Mercy,28641776,12551031,16090745,2015.csv,2015,0.43820714888629814,0.5617928511137019
1546,Maya the Bee Movie,28638603,0,28638603,2014.csv,2014,0.0,1.0
1547,The Four 2,28599970,0,28599970,2013.csv,2013,0.0,1.0
1548,Pokémon the Movie: Diancie and the Cocoon of Destruction,28595105,0,28595105,2014.csv,2014,0.0,1.0
1549,Flying Colors,28525563,0,28525563,2015.csv,2015,0.0,1.0
1550,Ala Vaikunthapurramuloo,28477890,0,28477890,2020.csv,2020,0.0,1.0
1551,Deranged,28444173,0,28444173,2012.csv,2012,0.0,1.0
1552,The Last Warrior: Root of Evil,28357398,0,28357398,2021.csv,2021,0.0,1.0
1553,The Kiyosu Conference,28338665,0,28338665,2013.csv,2013,0.0,1.0
1554,I Give It a Year,28328531,34657,28293874,2013.csv,2013,0.0012233955936507969,0.9987766044063492
1555,Gully Boy,28299498,5566534,22732964,2019.csv,2019,0.19670080366796613,0.8032991963320338
1556,The Master,28258060,16377274,11880786,2012.csv,2012,0.5795611588339752,0.42043884116602487
1557,Fan,28240000,2300000,25940000,2016.csv,2016,0.08144475920679886,0.9185552407932012
1558,"Yôkai Watch: the Movie: The Flying Whale and the Grand Adventure of the Double Worlds, Meow!",28110245,0,28110245,2016.csv,2016,0.0,1.0
1559,Triumph in the Skies,28085162,0,28085162,2015.csv,2015,0.0,1.0
1560,Welcome to Germany,28036021,0,28036021,2016.csv,2016,0.0,1.0
1561,Mandela: Long Walk to Freedom,27985788,8323085,19662703,2013.csv,2013,0.29740398948208996,0.70259601051791
1562,The Brothers Grimsby,27979040,6874837,21104203,2016.csv,2016,0.24571382720779555,0.7542861727922044
1563,What Happened to Monday,27975429,0,27975429,2017.csv,2017,0.0,1.0
1564,The 33,27972023,12227722,15744301,2015.csv,2015,0.4371411392018375,0.5628588607981625
1565,The Divine Move,27926871,136707,27790164,2014.csv,2014,0.004895177837860891,0.9951048221621391
1566,Monster Family,27890108,127259,27762849,2017.csv,2017,0.004562872255639885,0.9954371277443601
1567,The Beguiled,27869129,10709995,17159134,2017.csv,2017,0.3842960072415611,0.6157039927584389
1568,When Larry Meets Mary,27863090,0,27863090,2016.csv,2016,0.0,1.0
1569,Dark Skies,27858103,17418667,10439436,2013.csv,2013,0.6252639312877837,0.3747360687122163
1570,Kim Ji-young: Born 1982,27696393,0,27696393,2019.csv,2019,0.0,1.0
1571,Default,27694043,203775,27490268,2018.csv,2018,0.007358080580722721,0.9926419194192773
1572,Nebraska,27682872,17654912,10027960,2013.csv,2013,0.6377557935462765,0.36224420645372346
1573,Bride Wars,27670000,0,27670000,2015.csv,2015,0.0,1.0
1574,One Cut of the Dead,27590180,52406,27537774,2018.csv,2018,0.0018994439325876091,0.9981005560674124
1575,Nicholas on Holiday,27567832,0,27567832,2014.csv,2014,0.0,1.0
1576,Grace of Monaco,27515247,0,27515247,2014.csv,2014,0.0,1.0
1577,The Happytime Murders,27506452,20706452,6800000,2018.csv,2018,0.7527852737968532,0.2472147262031468
1578,The Incredible Burt Wonderstone,27437881,22537881,4900000,2013.csv,2013,0.8214147805364416,0.17858521946355843
1579,The 355,27414674,14570455,12844219,2022.csv,2022,0.5314837958678625,0.4685162041321374
1580,Yesterday Once More,27411872,0,27411872,2016.csv,2016,0.0,1.0
1581,Left Behind,27405896,14019924,13385972,2014.csv,2014,0.5115659783573578,0.48843402164264216
1582,Irrational Man,27391084,4030360,23360724,2015.csv,2015,0.14714131065422603,0.852858689345774
1583,Detective K: Secret of the Lost Island,27387870,185367,27202503,2015.csv,2015,0.006768215271943382,0.9932317847280566
1584,Gorko!,27369902,0,27369902,2013.csv,2013,0.0,1.0
1585,Midnight Sun,27365467,9561064,17804403,2018.csv,2018,0.34938428056060583,0.6506157194393942
1586,Pokémon: Mewtwo Strikes Back - Evolution,27347118,0,27347118,2019.csv,2019,0.0,1.0
1587,To the Fore,27267799,0,27267799,2015.csv,2015,0.0,1.0
1588,American Ultra,27262374,14440985,12821389,2015.csv,2015,0.5297038695162791,0.4702961304837209
1589,VIP Policeman,27222681,0,27222681,2018.csv,2018,0.0,1.0
1590,Khumba,27187375,1029,27186346,2013.csv,2013,3.7848449877930475e-05,0.999962151550122
1591,The Witches,27103571,203571,26900000,2020.csv,2020,0.0075108553039007295,0.9924891446960993
1592,Joy of Fatherhood,27088817,0,27088817,2014.csv,2014,0.0,1.0
1593,Scooby-Doo: A New Universe,27088425,2188425,24900000,2020.csv,2020,0.08078819643445494,0.9192118035655451
1594,My Neighbor Totoro 2018 Re-release,27083857,1144649,25939208,2018.csv,2018,0.042263145902741994,0.9577368540972581
1595,The Last Warrior: A Messenger of Darkness,27052365,0,27052365,2021.csv,2021,0.0,1.0
1596,Hitchcock,27039669,6008677,21030992,2012.csv,2012,0.22221710628188532,0.7777828937181147
1597,Almost a Comedy,26990962,0,26990962,2019.csv,2019,0.0,1.0
1598,Total Dhamaal,26911995,2167632,24744363,2019.csv,2019,0.08054519926895051,0.9194548007310495
1599,You're Next,26895481,18494006,8401475,2013.csv,2013,0.6876250326216512,0.3123749673783488
1600,Mr. Go,26835201,0,26835201,2013.csv,2013,0.0,1.0
1601,CHIPS,26800152,18600152,8200000,2017.csv,2017,0.6940315860895118,0.3059684139104883
1602,The Faces of My Gene,26796279,0,26796279,2018.csv,2018,0.0,1.0
1603,Dearest,26723916,0,26723916,2012.csv,2012,0.0,1.0
1604,Architecture 101,26642354,0,26642354,2012.csv,2012,0.0,1.0
1605,A Cure for Wellness,26620002,8106986,18513016,2017.csv,2017,0.3045449057441844,0.6954550942558156
1606,Missing Link,26565710,16649539,9916171,2019.csv,2019,0.626730435587831,0.3732695644121689
1607,American Underdog,26514814,26514814,0,2021.csv,2021,1.0,0.0
1608,Chaos Walking,26508132,13287908,13220224,2021.csv,2021,0.501276664836285,0.49872333516371503
1609,No Manches Frida 2,26493648,9270920,17222728,2019.csv,2019,0.3499299152762957,0.6500700847237043
1610,A Hard Day,26488847,19004,26469843,2014.csv,2014,0.0007174340204388662,0.9992825659795611
1611,The Break Up Man,26477012,0,26477012,2013.csv,2013,0.0,1.0
1612,The Way Way Back,26474920,21506546,4968374,2013.csv,2013,0.8123365811870253,0.18766341881297469
1613,We Are the Nobles,26433651,0,26433651,2013.csv,2013,0.0,1.0
1614,Dancing Queen,26411266,0,26411266,2012.csv,2012,0.0,1.0
1615,Emma.,26404660,10055355,16349305,2020.csv,2020,0.3808174390429568,0.6191825609570432
1616,Only the Brave,26351322,18343983,8007339,2017.csv,2017,0.6961314123063731,0.3038685876936269
1617,Twenty Two,26289378,46796,26242582,2017.csv,2017,0.0017800345067121785,0.9982199654932878
1618,Orange,26261536,0,26261536,2015.csv,2015,0.0,1.0
1619,Aloha,26250020,21067116,5182904,2015.csv,2015,0.8025561885286182,0.19744381147138174
1620,The Stolen Years,26249553,0,26249553,2013.csv,2013,0.0,1.0
1621,The Confidence Man JP,26228317,0,26228317,2019.csv,2019,0.0,1.0
1622,One Night Surprise,26220159,0,26220159,2013.csv,2013,0.0,1.0
1623,Lesson of the Evil,26167224,0,26167224,2012.csv,2012,0.0,1.0
1624,The Zookeeper's Wife,26152835,17571660,8581175,2017.csv,2017,0.6718835644395722,0.32811643556042774
1625,Badrinath Ki Dulhania,26134309,1993259,24141050,2017.csv,2017,0.0762698183449197,0.9237301816550803
1626,Badhaai Ho,26125610,0,26125610,2018.csv,2018,0.0,1.0
1627,Top Five,26117471,25317471,800000,2014.csv,2014,0.9693691628871723,0.030630837112827655
1628,Hichki,26055222,330279,25724943,2018.csv,2018,0.012676115367583512,0.9873238846324165
1629,Platinum Data,26052718,0,26052718,2013.csv,2013,0.0,1.0
1630,Iceman,26033917,7679,26026238,2014.csv,2014,0.0002949613767302093,0.9997050386232698
1631,Agneepath,26001696,1986748,24014948,2012.csv,2012,0.07640840043664844,0.9235915995633516
1632,The Courier,26001227,6613432,19387795,2021.csv,2021,0.25435076583116634,0.7456492341688337
1633,The Light Between Oceans,25975621,12545979,13429642,2016.csv,2016,0.48299053177592943,0.5170094682240706
1634,A Chinese Odyssey: Part 2 - Cinderella 2017 Re-release,25960664,0,25960664,2017.csv,2017,0.0,1.0
1635,Love Off the Cuff,25959989,0,25959989,2017.csv,2017,0.0,1.0
1636,The Confidence Man JP: The Movie,25958189,0,25958189,2019.csv,2019,0.0,1.0
1637,White Boy Rick,25957482,24011188,1946294,2018.csv,2018,0.925019922964793,0.07498007703520704
1638,Meet Miss Anxiety,25948636,0,25948636,2014.csv,2014,0.0,1.0
1639,"Paul, Apostle of Christ",25915966,17560475,8355491,2018.csv,2018,0.6775929170458087,0.32240708295419124
1640,Huevos: Little Rooster's Egg-cellent Adventure,25892561,9080818,16811743,2015.csv,2015,0.3507114649647827,0.6492885350352172
1641,Gekijouban SPEC: Kurôzu - Zen no hen,25860404,0,25860404,2013.csv,2013,0.0,1.0
1642,Dügün Dernek 2: Sünnet,25836668,0,25836668,2015.csv,2015,0.0,1.0
1643,Leap,25818882,83074,25735808,2020.csv,2020,0.00321756767004861,0.9967824323299513
1644,Unbeatable,25816154,0,25816154,2013.csv,2013,0.0,1.0
1645,Rust and Bone,25807712,2062027,23745685,2012.csv,2012,0.07989964395138942,0.9201003560486106
1646,"The Gangster, the Cop, the Devil",25775371,216494,25558877,2019.csv,2019,0.008399258346271718,0.9916007416537282
1647,Man on the Edge,25774679,0,25774679,2013.csv,2013,0.0,1.0
1648,Champions,25730347,0,25730347,2018.csv,2018,0.0,1.0
1649,A Beautiful Planet,25730120,15650615,10079505,2016.csv,2016,0.6082604744944835,0.3917395255055165
1650,Fireworks,25672406,525280,25147126,2017.csv,2017,0.020460879280266915,0.979539120719733
1651,Father Figures,25601244,17501244,8100000,2017.csv,2017,0.6836091246191005,0.31639087538089944
1652,"Love, Rosie",25574387,20431,25553956,2014.csv,2014,0.0007988852284123173,0.9992011147715877
1653,Mr. Donkey,25537759,356255,25181504,2016.csv,2016,0.013950127730471574,0.9860498722695284
1654,Look Who's Back,25513752,0,25513752,2015.csv,2015,0.0,1.0
1655,Money,25403753,0,25403753,2017.csv,2017,0.0,1.0
1656,Head Over Heels 2,25402893,0,25402893,2012.csv,2012,0.0,1.0
1657,Keys To The Heart,25375866,75134,25300732,2018.csv,2018,0.0029608447648643795,0.9970391552351356
1658,Serial Teachers 2,25364150,0,25364150,2015.csv,2015,0.0,1.0
1659,A Haunted House 2,25358716,17329486,8029230,2014.csv,2014,0.6833739531607199,0.31662604683928003
1660,And So It Goes,25312387,15160801,10151586,2014.csv,2014,0.5989478985130877,0.40105210148691234
1661,Bodies at Rest,25293853,0,25293853,2019.csv,2019,0.0,1.0
1662,Enough Said,25288872,17550872,7738000,2013.csv,2013,0.6940156128751017,0.3059843871248983
1663,On the Other Side of the Tracks,25109572,9572,25100000,2012.csv,2012,0.0003812092057961004,0.9996187907942039
1664,Born in China,25081168,13873211,11207957,2016.csv,2016,0.5531325734112542,0.4468674265887458
1665,Race,25070261,19206207,5864054,2016.csv,2016,0.7660952153629353,0.2339047846370646
1666,Herutâ sukerutâ,25066699,0,25066699,2012.csv,2012,0.0,1.0
1667,The Last Exorcism Part II,25051865,15179302,9872563,2013.csv,2013,0.6059150486400913,0.39408495135990873
1668,Call of Heroes,25040561,0,25040561,2016.csv,2016,0.0,1.0
1669,Free State of Jones,25035950,20810036,4225914,2016.csv,2016,0.8312061655339622,0.16879383446603785
1670,The Last Tycoon,25009914,0,25009914,2012.csv,2012,0.0,1.0
1671,"Me, Myself and Mum",24991467,0,24991467,2013.csv,2013,0.0,1.0
1672,Whiskey Tango Foxtrot,24972139,23083334,1888805,2016.csv,2016,0.924363507667485,0.07563649233251504
1673,Booksmart,24959607,22680962,2278645,2019.csv,2019,0.9087066955821861,0.09129330441781396
1674,Housefull 2,24922847,1791780,23131067,2012.csv,2012,0.07189307064317331,0.9281069293568267
1675,Wild City,24817852,34866,24782986,2015.csv,2015,0.0014048758127818636,0.9985951241872182
1676,Big Miracle,24719215,20157300,4561915,2012.csv,2012,0.815450652458017,0.18454934754198302
1677,Super 30,24701637,2269878,22431759,2019.csv,2019,0.09189180457959123,0.9081081954204088
1678,Soulmate,24684439,0,24684439,2016.csv,2016,0.0,1.0
1679,Drug War,24676341,128195,24548146,2013.csv,2013,0.005195057079167451,0.9948049429208325
1680,The Death of Stalin,24646055,8047856,16598199,2017.csv,2017,0.32653728963925466,0.6734627103607453
1681,The Snow Queen 3: Fire and Ice,24644317,0,24644317,2016.csv,2016,0.0,1.0
1682,Sparkle,24637800,24397469,240331,2012.csv,2012,0.9902454358749564,0.009754564125043632
1683,The Players,24629152,10854,24618298,2012.csv,2012,0.00044069726801799754,0.999559302731982
1684,Liar Game: Reborn,24549726,0,24549726,2012.csv,2012,0.0,1.0
1685,The Kashmir Files,24510593,1485000,23025593,2022.csv,2022,0.060586049468488994,0.939413950531511
1686,God's Not Dead 2,24487848,20774575,3713273,2016.csv,2016,0.8483626245964937,0.15163737540350627
1687,Skyfire,24444590,1105,24443485,2019.csv,2019,4.5204276283627584e-05,0.9999547957237164
1688,The Tale of The Princess Kaguya,24434485,703232,23731253,2013.csv,2013,0.028780307831329368,0.9712196921686707
1689,The 8-Year Engagement,24425963,0,24425963,2017.csv,2017,0.0,1.0
1690,Stan & Ollie,24420923,5470235,18950688,2018.csv,2018,0.22399788083357866,0.7760021191664214
1691,The Witch: Part 1 - The Subversion,24340302,0,24340302,2018.csv,2018,0.0,1.0
1692,The Great Beauty,24271739,2852400,21419339,2013.csv,2013,0.11751939158541545,0.8824806084145845
1693,Trance,24261569,2328743,21932826,2013.csv,2013,0.09598484747626998,0.90401515252373
1694,The Accidental Detective 2: In Action,24243825,179045,24064780,2018.csv,2018,0.0073851795250955655,0.9926148204749045
1695,Camping 3,24224579,0,24224579,2016.csv,2016,0.0,1.0
1696,Jolly LLB 2,24214186,1654254,22559932,2017.csv,2017,0.06831755566757437,0.9316824443324256
1697,The Railway Man,24174885,4438438,19736447,2013.csv,2013,0.18359706778336277,0.8164029322166372
1698,The Founder,24121245,12786053,11335192,2016.csv,2016,0.5300743390318369,0.46992566096816313
1699,Out of Inferno,24109886,0,24109886,2013.csv,2013,0.0,1.0
1700,Start-Up,24106579,0,24106579,2019.csv,2019,0.0,1.0
1701,Bad Santa 2,24079268,17782178,6297090,2016.csv,2016,0.7384849904905747,0.2615150095094253
1702,Kung Fu Jungle,24070765,129784,23940981,2014.csv,2014,0.0053917688116684286,0.9946082311883315
1703,I Can Speak,24024444,63239,23961205,2017.csv,2017,0.0026322773588433514,0.9973677226411567
1704,Bring Happiness Home,23980000,0,23980000,2013.csv,2013,0.0,1.0
1705,The Father,23962107,2122771,21839336,2020.csv,2020,0.08858866209052485,0.9114113379094751
1706,I Want You,23961214,0,23961214,2012.csv,2012,0.0,1.0
1707,Türkisch für Anfänger,23952712,0,23952712,2012.csv,2012,0.0,1.0
1708,Killing for the Prosecution,23929620,0,23929620,2018.csv,2018,0.0,1.0
1709,Pinocchio,23889592,1831718,22057874,2019.csv,2019,0.07667431072075237,0.9233256892792476
1710,Spirits' Homecoming,23857217,125616,23731601,2016.csv,2016,0.0052653249538703525,0.9947346750461297
1711,Silence,23834809,7100177,16734632,2016.csv,2016,0.2978910802264033,0.7021089197735967
1712,Wanderlust,23812816,17450535,6362281,2012.csv,2012,0.7328211413551425,0.26717885864485746
1713,A Rainy Day in New York,23794991,0,23794991,2019.csv,2019,0.0,1.0
1714,"Little Brother, Big Trouble: A Christmas Adventure",23785681,0,23785681,2012.csv,2012,0.0,1.0
1715,Interstellar 2020 Re-release,23771122,0,23771122,2020.csv,2020,0.0,1.0
1716,Pokémon the Movie: The Power of Us,23740788,789170,22951618,2018.csv,2018,0.0332411038757433,0.9667588961242567
1717,The Peanut Butter Falcon,23712090,20457151,3254939,2019.csv,2019,0.862730826342174,0.13726917365782604
1718,To the Arctic 3D,23695388,14560838,9134550,2012.csv,2012,0.6145009315736886,0.3854990684263115
1719,Little White Lies 2,23623665,0,23623665,2019.csv,2019,0.0,1.0
1720,Kevin Hart: What Now?,23591043,23591043,0,2016.csv,2016,1.0,0.0
1721,No manches Frida,23540937,11528613,12012324,2016.csv,2016,0.48972617360133114,0.5102738263986688
1722,Those Who Wish Me Dead,23468586,7407200,16061386,2021.csv,2021,0.31562191262822564,0.6843780873717743
1723,Wish Upon,23468586,14301505,9167081,2017.csv,2017,0.6093892917110558,0.39061070828894423
1724,Ossan's Love: Love or Dead,23422744,0,23422744,2019.csv,2019,0.0,1.0
1725,Only Cloud Knows,23410836,0,23410836,2019.csv,2019,0.0,1.0
1726,Detroit,23355100,16790139,6564961,2017.csv,2017,0.7189067484189748,0.2810932515810251
1727,Middle School: The Worst Years of My Life,23316139,20007149,3308990,2016.csv,2016,0.8580815631610362,0.14191843683896377
1728,Triple 9,23177948,12639297,10538651,2016.csv,2016,0.5453156163781194,0.4546843836218806
1729,Rock Dog,23157646,9420546,13737100,2016.csv,2016,0.40680067395451164,0.5931993260454884
1730,The Guernsey Literary and Potato Peel Pie Society,23148937,0,23148937,2018.csv,2018,0.0,1.0
1731,The Crimes That Bind,23144130,0,23144130,2018.csv,2018,0.0,1.0
1732,New Happy Dad and Son 3: Adventure in Russia,23130469,0,23130469,2018.csv,2018,0.0,1.0
1733,Dark Waters,23108017,11136084,11971933,2019.csv,2019,0.48191430705629135,0.5180856929437087
1734,The Confidence Man JP: Episode of the Hero,23100870,0,23100870,2022.csv,2022,0.0,1.0
1735,The Marksman,23076711,15566093,7510618,2021.csv,2021,0.6745368956607378,0.32546310433926223
1736,The Farewell,23076657,17695781,5380876,2019.csv,2019,0.7668260181706562,0.23317398182934382
1737,The Choice,23064015,18730891,4333124,2016.csv,2016,0.8121262061267304,0.1878737938732697
1738,99.9 Criminal Lawyer: The Movie,23055069,0,23055069,2021.csv,2021,0.0,1.0
1739,Padmaavat,22991060,11846060,11145000,2018.csv,2018,0.5152463609768319,0.48475363902316815
1740,Hotaru the Movie: It's Only a Little Light in My Life,22975341,0,22975341,2012.csv,2012,0.0,1.0
1741,Last Night in Soho,22957625,10127625,12830000,2021.csv,2021,0.4411442821284867,0.5588557178715132
1742,Penny Pincher!,22955486,0,22955486,2016.csv,2016,0.0,1.0
1743,Hot Road,22916313,0,22916313,2014.csv,2014,0.0,1.0
1744,Baggage Claim,22871096,21569509,1301587,2013.csv,2013,0.9430903092707057,0.056909690729294304
1745,Won't You Be My Neighbor?,22844741,22835787,8954,2018.csv,2018,0.9996080498351897,0.0003919501648103605
1746,Kon-Tiki,22842887,1517410,21325477,2012.csv,2012,0.06642811830220935,0.9335718816977907
1747,The Knight of Shadows: Between Yin and Yang,22774256,0,22774256,2019.csv,2019,0.0,1.0
1748,Extraordinary Mission,22757764,54174,22703590,2017.csv,2017,0.0023804623336457836,0.9976195376663543
1749,Black and Blue,22741061,22055313,685748,2019.csv,2019,0.9698453823240701,0.030154617675929897
1750,Fading Gigolo,22706304,3769873,18936431,2014.csv,2014,0.1660275930420028,0.8339724069579972
1751,Fall in Love Like a Star,22640355,0,22640355,2012.csv,2012,0.0,1.0
1752,The Day We Lit Up the Sky,22500000,0,22500000,2021.csv,2021,0.0,1.0
1753,Europe Raiders,22435156,0,22435156,2018.csv,2018,0.0,1.0
1754,Late Night,22386555,15499454,6887101,2019.csv,2019,0.6923554785450463,0.30764452145495363
1755,Mojin: The Worm Valley,22381583,101516,22280067,2018.csv,2018,0.004535693476194244,0.9954643065238058
1756,Les Misérables,22342519,330181,22012338,2019.csv,2019,0.01477814565134755,0.9852218543486525
1757,Spencer,22301766,7086632,15215134,2021.csv,2021,0.31776102394761024,0.6822389760523897
1758,Upside Down,22187813,105095,22082718,2012.csv,2012,0.004736609236791386,0.9952633907632086
1759,Unbowed,22132903,0,22132903,2012.csv,2012,0.0,1.0
1760,The Glass Castle,22088533,17273059,4815474,2017.csv,2017,0.7819921313923383,0.21800786860766172
1761,Stree,22075730,0,22075730,2018.csv,2018,0.0,1.0
1762,Gretel & Hansel,22051055,15347654,6703401,2020.csv,2020,0.6960054292186927,0.3039945707813073
1763,Kaamelott: First Installment,21965451,188000,21777451,2021.csv,2021,0.00855889551277595,0.991441104487224
1764,Leap! 2017 Re-release,21929861,21858070,71791,2017.csv,2017,0.9967263358395204,0.003273664160479631
1765,Poupelle of Chimney Town,21831861,0,21831861,2020.csv,2020,0.0,1.0
1766,Confession of Murder,21701525,0,21701525,2012.csv,2012,0.0,1.0
1767,StreetDance 2 2012 Re-release,21638853,0,21638853,2012.csv,2012,0.0,1.0
1768,After We Fell,21584600,2170750,19413850,2021.csv,2021,0.10056938743363324,0.8994306125663668
1769,Épouse-moi mon pote,21571464,0,21571464,2017.csv,2017,0.0,1.0
1770,2012 2012 Re-release,21538353,0,21538353,2012.csv,2012,0.0,1.0
1771,Crazy Romance,21386368,0,21386368,2019.csv,2019,0.0,1.0
1772,Shaft,21360215,21360215,0,2019.csv,2019,1.0,0.0
1773,Unplanned,21354152,19005109,2349043,2019.csv,2019,0.8899959595679566,0.11000404043204338
1774,Rurouni Kenshin: Final Chapter Part II - The Beginning,21318560,0,21318560,2021.csv,2021,0.0,1.0
1775,Hotel Mumbai,21314816,9651611,11663205,2019.csv,2019,0.4528123067072219,0.5471876932927782
1776,Integrity,21290004,0,21290004,2019.csv,2019,0.0,1.0
1777,Stigmatized Properties,21276720,0,21276720,2020.csv,2020,0.0,1.0
1778,The Prison,21205329,207481,20997848,2017.csv,2017,0.009784380143312088,0.9902156198566879
1779,Wish Dragon,21120000,0,21120000,2021.csv,2021,0.0,1.0
1780,Beasts of the Southern Wild,21107746,12795746,8312000,2012.csv,2012,0.6062109142302546,0.39378908576974536
1781,Pokémon the Movie: Secrets of the Jungle,21097921,0,21097921,2020.csv,2020,0.0,1.0
1782,The Secret Mission,21083522,0,21083522,2019.csv,2019,0.0,1.0
1783,The Photograph,20690779,20578185,112594,2020.csv,2020,0.9945582522533347,0.005441747746665314
1784,Yarn,20474270,0,20474270,2020.csv,2020,0.0,1.0
1785,One Hundred Thousand Bad Jokes 2,20460352,0,20460352,2017.csv,2017,0.0,1.0
1786,Violet Evergarden: The Movie,20339624,0,20339624,2020.csv,2020,0.0,1.0
1787,Brahms: The Boy II,20311536,12611536,7700000,2020.csv,2020,0.6209050856616654,0.37909491433833464
1788,This Is Tomas,20084169,0,20084169,2019.csv,2019,0.0,1.0
1789,Ice 2,19788995,0,19788995,2020.csv,2020,0.0,1.0
1790,Stillwater,19697881,14465535,5232346,2021.csv,2021,0.7343701081349816,0.2656298918650184
1791,Soul Snatcher,19561221,0,19561221,2020.csv,2020,0.0,1.0
1792,The Turning,19428166,15472775,3955391,2020.csv,2020,0.7964094500736714,0.2035905499263286
1793,The Specials,19363826,0,19363826,2019.csv,2019,0.0,1.0
1794,Les Tuche 4,19259766,0,19259766,2021.csv,2021,0.0,1.0
1795,Fate/Stay Night: Heaven's Feel - III. Spring Song,19252497,200000,19052497,2020.csv,2020,0.010388262883510644,0.9896117371164893
1796,Dear Evan Hansen,19046191,15002646,4043545,2021.csv,2021,0.7876979706861073,0.21230202931389275
1797,Always Miss You,19015465,91884,18923581,2019.csv,2019,0.0048320669518205316,0.9951679330481795
1798,The Pioneer,18900000,0,18900000,2021.csv,2021,0.0,1.0
1799,The Green Knight,18888418,17173321,1715097,2021.csv,2021,0.9091984834304281,0.09080151656957189
1800,An Officer and a Spy,18878658,0,18878658,2019.csv,2019,0.0,1.0
1801,Antlers,18867659,10619670,8247989,2021.csv,2021,0.5628504309941154,0.43714956900588464
1802,Sinkhole,18804231,0,18804231,2021.csv,2021,0.0,1.0
1803,Crayon Shin-chan: Honeymoon Hurricane - The Lost Hiroshi,18738951,0,18738951,2019.csv,2019,0.0,1.0
1804,Mobile Suit Gundam: Hathaway,18731309,0,18731309,2021.csv,2021,0.0,1.0
1805,Greta,18653107,10532219,8120888,2019.csv,2019,0.56463617562479,0.43536382437521
1806,Peppa Celebrates Chinese New Year,18653040,131225,18521815,2019.csv,2019,0.0070350462980833155,0.9929649537019167
1807,Parallel Mothers,18591272,2155490,16435782,2021.csv,2021,0.11594096412553159,0.8840590358744684
1808,Takizawa Enbujo Zero,18091395,0,18091395,2020.csv,2020,0.0,1.0
1809,The Stronghold,18066143,0,18066143,2021.csv,2021,0.0,1.0
1810,The Promised Neverland,17698106,0,17698106,2020.csv,2020,0.0,1.0
1811,Kaiji: Final Game,17645779,0,17645779,2020.csv,2020,0.0,1.0
1812,Hitman: Agent Jun,17601351,0,17601351,2020.csv,2020,0.0,1.0
1813,Bo Gia,17480489,350000,17130489,2021.csv,2021,0.020022323174140037,0.97997767682586
1814,The Dry,17392594,364237,17028357,2021.csv,2021,0.02094207454046245,0.9790579254595375
1815,Digimon Adventure: Last Evolution Kizuna,17337522,0,17337522,2020.csv,2020,0.0,1.0
1816,Gintama: The Final,17252960,0,17252960,2021.csv,2021,0.0,1.0
1817,Railway Heroes,17223542,0,17223542,2021.csv,2021,0.0,1.0
1818,Promising Young Woman,17192816,6460965,10731851,2020.csv,2020,0.3757944597324836,0.6242055402675164
1819,The Wolf and the Lion,16975717,1851627,15124090,2021.csv,2021,0.10907503936358035,0.8909249606364197
1820,Bye Bye Morons,16955173,0,16955173,2020.csv,2020,0.0,1.0
1821,Baaghi 3,16726510,721439,16005071,2020.csv,2020,0.043131472136147944,0.956868527863852
1822,Your Turn to Kill,16511822,0,16511822,2021.csv,2021,0.0,1.0
1823,I Still Believe,16069730,9868521,6201209,2020.csv,2020,0.6141062108697533,0.38589378913024674
1824,Upon the Magic Roads,15990882,0,15990882,2021.csv,2021,0.0,1.0
1825,Radhe Shyam,15964263,1860000,14104263,2022.csv,2022,0.11651023288704276,0.8834897671129572
1826,Freaky,15920855,9030855,6890000,2020.csv,2020,0.5672342974042537,0.43276570259574626
1827,Reminiscence,15800193,3900193,11900000,2021.csv,2021,0.24684464297366493,0.7531553570263351
1828,Cry Macho,15522017,10310734,5211283,2021.csv,2021,0.6642650887445878,0.3357349112554122
1829,The Night House,15437703,7100581,8337122,2021.csv,2021,0.45995061571012213,0.5400493842898778
1830,Padre no hay más que uno 2: La llegada de la suegra,15373181,0,15373181,2020.csv,2020,0.0,1.0
1831,Minari,15322552,3110580,12211972,2021.csv,2021,0.2030066531998064,0.7969933468001936
1832,Bheemla Nayak,15243922,0,15243922,2022.csv,2022,0.0,1.0
1833,Something About Love,15204017,0,15204017,2021.csv,2021,0.0,1.0
1834,Anita,15026604,556632,14469972,2021.csv,2021,0.03704310035720646,0.9629568996427935
1835,Blacklight,14829206,9591094,5238112,2022.csv,2022,0.6467705688355803,0.35322943116441974
1836,The Way Back,14690514,13590514,1100000,2020.csv,2020,0.9251217486331655,0.0748782513668344
1837,The Tomorrow War,14400000,0,14400000,2021.csv,2021,0.0,1.0
1838,The Personal History of David Copperfield,14399270,1876298,12522972,2020.csv,2020,0.130305077965758,0.869694922034242
1839,"And, the Baton Was Passed",14368469,0,14368469,2021.csv,2021,0.0,1.0
1840,Nightlife,14308789,0,14308789,2020.csv,2020,0.0,1.0
1841,Super-héros malgré lui,14280614,0,14280614,2022.csv,2022,0.0,1.0
1842,Pawn,14193957,0,14193957,2020.csv,2020,0.0,1.0
1843,Crayon Shin-chan: Shrouded in Mystery! The Flowers of Tenkazu Academy,14059824,0,14059824,2021.csv,2021,0.0,1.0
1844,Sword Art Online: Progressive - Aria of a Starless Night,14034582,1050000,12984582,2021.csv,2021,0.07481519577854188,0.9251848042214581
1845,Maison de retraite,13782342,0,13782342,2022.csv,2022,0.0,1.0
1846,Christmas with the Chosen: The Messengers,13728000,13728000,0,2021.csv,2021,1.0,0.0
1847,Wunderschön,13471720,0,13471720,2022.csv,2022,0.0,1.0
1848,OSS 117: From Africa with Love,13433702,0,13433702,2021.csv,2021,0.0,1.0
1849,#Alive,13432212,0,13432212,2020.csv,2020,0.0,1.0
1850,Howling Village,13394556,0,13394556,2020.csv,2020,0.0,1.0
1851,Valimai,13276393,0,13276393,2022.csv,2022,0.0,1.0
1852,Come Play,13182254,10475990,2706264,2020.csv,2020,0.7947040013035707,0.2052959986964293
1853,Hostage: Missing Celebrity,13125970,0,13125970,2021.csv,2021,0.0,1.0
1854,Eiffel,13082620,0,13082620,2021.csv,2021,0.0,1.0
1855,Vakeel Saab,13056490,0,13056490,2021.csv,2021,0.0,1.0
1856,School of Magical Animals,13020757,0,13020757,2021.csv,2021,0.0,1.0
1857,Monkey King Reborn,13002635,0,13002635,2021.csv,2021,0.0,1.0
1858,No Escapes,12916151,0,12916151,2021.csv,2021,0.0,1.0
1859,The Bodin's in the Land of Smile,12872253,0,12872253,2021.csv,2021,0.0,1.0
1860,Samjin Company English Class,12761386,0,12761386,2020.csv,2020,0.0,1.0
1861,The Many Saints of Newark,12737403,8237403,4500000,2021.csv,2021,0.6467097727849233,0.35329022721507675
1862,Another Round,12733781,0,12733781,2020.csv,2020,0.0,1.0
1863,News of the World,12668325,12668325,0,2020.csv,2020,1.0,0.0
1864,Collectors,12640113,0,12640113,2020.csv,2020,0.0,1.0
1865,Character,12571501,0,12571501,2021.csv,2021,0.0,1.0
1866,The Last 10 Years,12515780,0,12515780,2022.csv,2022,0.0,1.0
1867,Shinchan: Crash! Scribble Kingdom and Almost Four Heroes,12221804,0,12221804,2020.csv,2020,0.0,1.0
1868,Ducobu 3,12157793,0,12157793,2020.csv,2020,0.0,1.0
1869,On Your Mark,12100000,0,12100000,2021.csv,2021,0.0,1.0
1870,Stand by Me,11900000,0,11900000,2021.csv,2021,0.0,1.0
1871,On the Line,11772156,0,11772156,2021.csv,2021,0.0,1.0
1872,Wotakoi: Love Is Hard for Otaku,11702371,0,11702371,2020.csv,2020,0.0,1.0
1873,Let Him Go,11630934,9358025,2272909,2020.csv,2020,0.8045806983342868,0.19541930166571317
1874,The Lost City,11550000,11550000,0,2022.csv,2022,1.0,0.0
1875,The Hunt,11481750,5812500,5669250,2020.csv,2020,0.5062381605591482,0.4937618394408518
1876,The Fable: The Killer Who Doesn't Kill,11325545,0,11325545,2021.csv,2021,0.0,1.0
1877,What Did You Eat Yesterday?,11320893,0,11320893,2021.csv,2021,0.0,1.0
1878,Aline,11088475,606464,10482011,2021.csv,2021,0.054693183688469336,0.9453068163115307
1879,Drive My Car,11041495,2175436,8866059,2021.csv,2021,0.19702368202856588,0.8029763179714341
1880,30 jours max,10998969,0,10998969,2020.csv,2020,0.0,1.0
1881,The Voice of Sin,10983063,0,10983063,2020.csv,2020,0.0,1.0
1882,Bigfoot Family,10855626,0,10855626,2020.csv,2020,0.0,1.0
1883,Harry Potter and the Sorcerer's Stone 2021 Re-release,10795457,799342,9996115,2021.csv,2021,0.07404429474361299,0.925955705256387
1884,Me contro Te - Il film: La vendetta del Signor S,10779891,0,10779891,2020.csv,2020,0.0,1.0
1885,One Second,10764400,0,10764400,2020.csv,2020,0.0,1.0
1886,Impractical Jokers: The Movie,10691091,10691091,0,2020.csv,2020,1.0,0.0
1887,Honest Candidate,10597464,0,10597464,2020.csv,2020,0.0,1.0
1888,Krack,10442916,0,10442916,2021.csv,2021,0.0,1.0
1889,Kaiserschmarrndrama,10357720,0,10357720,2021.csv,2021,0.0,1.0
1890,"Caution, Hazardous Wife: The Movie",10356359,0,10356359,2021.csv,2021,0.0,1.0
1891,Realm of Terracotta,10341512,0,10341512,2021.csv,2021,0.0,1.0
1892,Street Dancer 3D,10339127,0,10339127,2020.csv,2020,0.0,1.0
1893,Detective Conan: The Scarlet Alibi,10308627,0,10308627,2021.csv,2021,0.0,1.0
1894,The Pirates: The Last Royal Treasure,10266142,0,10266142,2022.csv,2022,0.0,1.0
1895,Never Stop,10224935,0,10224935,2021.csv,2021,0.0,1.0
1896,My Spy,10200000,0,10200000,2020.csv,2020,0.0,1.0
1897,The Asadas,10066797,0,10066797,2020.csv,2020,0.0,1.0
1898,Beauty and the Beast 2020 Re-release,10055094,467000,9588094,2020.csv,2020,0.046444120761078914,0.953555879238921
1899,Doraemon the Movie: Nobita's Little Star Wars 2021,9992175,0,9992175,2022.csv,2022,0.0,1.0
1900,Vaillante,9904495,0,9904495,2022.csv,2022,0.0,1.0
1901,Sumikko Gurashi The Movie: The Magical Child Of The Blue Moonlit Night,9735732,0,9735732,2021.csv,2021,0.0,1.0
1902,Stolen Identity 2,9687188,0,9687188,2020.csv,2020,0.0,1.0
1903,Black Box,9639918,0,9639918,2021.csv,2021,0.0,1.0
1904,The Soul,9600000,0,9600000,2021.csv,2021,0.0,1.0
1905,Ainbo,9561522,0,9561522,2021.csv,2021,0.0,1.0
1906,¡A todo tren! Destino Asturias,9544171,0,9544171,2021.csv,2021,0.0,1.0
1907,Baragaki: Unbroken Samurai,9481437,0,9481437,2021.csv,2021,0.0,1.0
1908,10 Days with Dad,9472077,2359,9469718,2020.csv,2020,0.000249047806515931,0.9997509521934841
1909,Secret Zoo,9471940,0,9471940,2020.csv,2020,0.0,1.0
1910,365 Days,9458590,0,9458590,2020.csv,2020,0.0,1.0
1911,Redeeming Love,9436988,9214020,222968,2022.csv,2022,0.9763729698501259,0.023627030149874093
1912,Okay Madam,9433525,0,9433525,2020.csv,2020,0.0,1.0
1913,Bergen,9349634,0,9349634,2022.csv,2022,0.0,1.0
1914,L'appel de la forêt,9317347,0,9317347,2020.csv,2020,0.0,1.0
1915,Inception 10th Anniversary re-release,9100000,0,9100000,2020.csv,2020,0.0,1.0
1916,The Closet,9039424,0,9039424,2020.csv,2020,0.0,1.0
1917,Malasaña 32,8968845,0,8968845,2020.csv,2020,0.0,1.0
1918,Break the Silence: The Movie,8954345,0,8954345,2020.csv,2020,0.0,1.0
1919,I Hate Summer,8926071,0,8926071,2020.csv,2020,0.0,1.0
1920,All About My Mother,8900000,0,8900000,2021.csv,2021,0.0,1.0
1921,Downhill,8899195,8287061,612134,2020.csv,2020,0.9312146772826081,0.06878532271739185
1922,Legend No. 17,8869709,0,8869709,2021.csv,2021,0.0,1.0
1923,Les blagues de Toto,8859185,0,8859185,2020.csv,2020,0.0,1.0
1924,The Eleventh Chapter,8845525,0,8845525,2021.csv,2021,0.0,1.0
1925,The Vault,8808878,0,8808878,2021.csv,2021,0.0,1.0
1926,Kaguya-sama: Love Is War,8794981,0,8794981,2021.csv,2021,0.0,1.0
1927,The Worst Person in the World,8763377,2829379,5933998,2021.csv,2021,0.3228640055083788,0.6771359944916212
1928,The Secret Garden,8721243,0,8721243,2020.csv,2020,0.0,1.0
1929,Turning Red,8643727,0,8643727,2022.csv,2022,0.0,1.0
1930,Eltilerin Savasi,8613864,0,8613864,2020.csv,2020,0.0,1.0
1931,100% Wolf,8535117,658764,7876353,2020.csv,2020,0.0771827732414213,0.9228172267585787
1932,Agent Backkom: Kings Bear,8500000,0,8500000,2021.csv,2021,0.0,1.0
1933,Honey Lemon Soda,8441488,0,8441488,2021.csv,2021,0.0,1.0
1934,The Medium,8441072,0,8441072,2021.csv,2021,0.0,1.0
1935,The Bad Guys,8438000,0,8438000,2022.csv,2022,0.0,1.0
1936,Delicious,8437097,0,8437097,2021.csv,2021,0.0,1.0
1937,Malang,8399765,0,8399765,2020.csv,2020,0.0,1.0
1938,The Lord of the Rings: The Fellowship of the Ring 2021 Re-release,8377569,0,8377569,2021.csv,2021,0.0,1.0
1939,The Protégé,8364568,7446823,917745,2021.csv,2021,0.8902818412140352,0.1097181587859648
1940,I Don't Have Any Money Left in My Retirement Account,8204616,0,8204616,2021.csv,2021,0.0,1.0
1941,White Snake 2: Green Snake,8170000,0,8170000,2021.csv,2021,0.0,1.0
1942,Lost Illusions,8071887,0,8071887,2021.csv,2021,0.0,1.0
1943,New Happy Dad and Son 4,8070000,0,8070000,2021.csv,2021,0.0,1.0
1944,Your Eyes Tell,8020474,0,8020474,2020.csv,2020,0.0,1.0
1945,Two by Two: Overboard!,7940954,0,7940954,2020.csv,2020,0.0,1.0
1946,AI Amok,7932191,0,7932191,2020.csv,2020,0.0,1.0
1947,Sunny Sisters,7880000,0,7880000,2021.csv,2021,0.0,1.0
1948,The Lost Prince,7837980,0,7837980,2020.csv,2020,0.0,1.0
1949,Antoinette dans les Cévennes,7821615,0,7821615,2020.csv,2020,0.0,1.0
1950,Antebellum,7792431,0,7792431,2020.csv,2020,0.0,1.0
1951,The Marriage Escape,7760946,0,7760946,2020.csv,2020,0.0,1.0
1952,Spirited Away Studio Ghibli Fest 2020,7732435,0,7732435,2020.csv,2020,0.0,1.0
1953,Smack Dab Kakha,7692780,0,7692780,2020.csv,2020,0.0,1.0
1954,Princess Mononoke Studio Ghibli Fest 2020,7673207,0,7673207,2020.csv,2020,0.0,1.0
1955,Hard Hit,7633895,0,7633895,2021.csv,2021,0.0,1.0
1956,The Heist of the Century,7627100,0,7627100,2020.csv,2020,0.0,1.0
1957,Little Canned Men,7600000,0,7600000,2021.csv,2021,0.0,1.0
1958,Pushpa: The Rise - Part 1,7592374,1320000,6272374,2021.csv,2021,0.1738586639699256,0.8261413360300743
1959,The Mauritanian,7527030,836536,6690494,2021.csv,2021,0.11113759344655195,0.8888624065534481
1960,The Ice Road,7502846,0,7502846,2021.csv,2021,0.0,1.0
1961,De Gaulle,7501454,0,7501454,2020.csv,2020,0.0,1.0
1962,Fukushima 50,7494243,0,7494243,2020.csv,2020,0.0,1.0
1963,"Turu, the Wacky Hen",7431553,0,7431553,2020.csv,2020,0.0,1.0
1964,Love Letter 2021 Re-release,7400000,0,7400000,2021.csv,2021,0.0,1.0
1965,'83,7351061,4055660,3295401,2021.csv,2021,0.5517108346672678,0.4482891653327322
1966,The Best Years,7344947,0,7344947,2020.csv,2020,0.0,1.0
1967,Signal: The Movie,7344186,0,7344186,2021.csv,2021,0.0,1.0
1968,Contra,7216863,0,7216863,2021.csv,2021,0.0,1.0
1969,Mamma Mia! Here We Go Again 2020 Re-release,7209678,0,7209678,2020.csv,2020,0.0,1.0
1970,Water Boys,7200000,0,7200000,2021.csv,2021,0.0,1.0
1971,Dear Tutu: Operation T-Rex,7200000,0,7200000,2021.csv,2021,0.0,1.0
1972,X,7177008,6784092,392916,2022.csv,2022,0.9452535095404659,0.054746490459534114
1973,Couple from the Future,7160729,0,7160729,2021.csv,2021,0.0,1.0
1974,The (UN)perfect Guy,7154649,0,7154649,2020.csv,2020,0.0,1.0
1975,Bohemian Rhapsody 2020 Re-release,7154052,240000,6914052,2020.csv,2020,0.03354742179676636,0.9664525782032336
1976,Back to the Wharf,7090000,0,7090000,2020.csv,2020,0.0,1.0
1977,Adu,7085946,0,7085946,2020.csv,2020,0.0,1.0
1978,The Duke,7040314,0,7040314,2022.csv,2022,0.0,1.0
1979,Fatale,7031289,6306897,724392,2020.csv,2020,0.896975931440167,0.10302406855983305
1980,Spycies,6989285,0,6989285,2020.csv,2020,0.0,1.0
1981,Sooryavanshi,6984082,3547776,3436306,2021.csv,2021,0.5079802900366863,0.49201970996331373
1982,Jim Button and the Wild 13,6913938,0,6913938,2020.csv,2020,0.0,1.0
1983,Dragon Rider,6779816,0,6779816,2020.csv,2020,0.0,1.0
1984,Psy 3: W imie zasad,6725146,0,6725146,2020.csv,2020,0.0,1.0
1985,Blood Moon Party,6709383,0,6709383,2020.csv,2020,0.0,1.0
1986,Innocence,6659968,0,6659968,2020.csv,2020,0.0,1.0
1987,Shubh Mangal Zyada Saavdhan,6574905,0,6574905,2020.csv,2020,0.0,1.0
1988,Chhapaak,6532100,604334,5927766,2020.csv,2020,0.09251756709174691,0.907482432908253
1989,"Love Me, Love Me Not",6494241,0,6494241,2020.csv,2020,0.0,1.0
1990,Hammamet,6434874,0,6434874,2020.csv,2020,0.0,1.0
1991,Lindenberg! Mach dein Ding,6404964,0,6404964,2020.csv,2020,0.0,1.0
1992,Midnight Swan,6397065,0,6397065,2020.csv,2020,0.0,1.0
1993,Nausicaä of the Valley of the Wind 2020 Re-release,6395525,0,6395525,2020.csv,2020,0.0,1.0
1994,Simply Black,6323750,0,6323750,2020.csv,2020,0.0,1.0
1995,My Boyfriend's Meds,6292780,2971116,3321664,2020.csv,2020,0.47214680951820975,0.5278531904817902
1996,Bill & Ted Face the Music,6274027,3439660,2834367,2020.csv,2020,0.5482379977006793,0.4517620022993207
1997,Hotel Belgrade,6199413,0,6199413,2020.csv,2020,0.0,1.0
1998,Cyrano,6161016,3788241,2372775,2022.csv,2022,0.6148727742307437,0.38512722576925623
1999,Kingmaker,6049522,0,6049522,2022.csv,2022,0.0,1.0
2000,How to Be a Good Wife,6029102,0,6029102,2020.csv,2020,0.0,1.0
2001,The Legacy Of Dr. Death: Black File,6024046,0,6024046,2020.csv,2020,0.0,1.0
2002,The Rhythm Section,5989583,5437971,551612,2020.csv,2020,0.9079047740051353,0.09209522599486475
2003,Jak zostalem gangsterem. Historia prawdziwa,5975729,0,5975729,2020.csv,2020,0.0,1.0
2004,The Lion King 2020 Re-release,5948352,0,5948352,2020.csv,2020,0.0,1.0
2005,Twiceborn,5880157,11527,5868630,2020.csv,2020,0.001960321807734045,0.9980396781922659
2006,The Policeman's Lineage,5869939,0,5869939,2022.csv,2022,0.0,1.0
2007,The Royal Bride,5830719,0,5830719,2020.csv,2020,0.0,1.0
2008,Beasts Clawing at Straws,5796059,0,5796059,2020.csv,2020,0.0,1.0
2009,Adieu Monsieur Haffmann,5781484,0,5781484,2022.csv,2022,0.0,1.0
2010,Bheeshma Parvam,5758666,0,5758666,2022.csv,2022,0.0,1.0
2011,Last Letter,5663972,0,5663972,2020.csv,2020,0.0,1.0
2012,Yowamushi Pedal: The Movie 2020 Re-release,5624218,0,5624218,2020.csv,2020,0.0,1.0
2013,Hocus Pocus 2020 Re-release,5609193,4828000,781193,2020.csv,2020,0.8607298768289842,0.13927012317101586
2014,Klassikokkutulek 2: Pulmad ja matused,5543147,0,5543147,2020.csv,2020,0.0,1.0
2015,Mama Weed,5432038,29151,5402887,2020.csv,2020,0.005366494122463797,0.9946335058775362
2016,RRR,5400000,5400000,0,2022.csv,2022,1.0,0.0
2017,Chickenhare and the Hamster of Darkness,5378720,0,5378720,2022.csv,2022,0.0,1.0
2018,Divorce Club,5316313,0,5316313,2020.csv,2020,0.0,1.0
2019,A Piece of Cake,5253994,0,5253994,2020.csv,2020,0.0,1.0
2020,Cindy La Regia,5222322,0,5222322,2020.csv,2020,0.0,1.0
2021,Run,5184368,0,5184368,2020.csv,2020,0.0,1.0
2022,Love Aaj Kal,5120794,0,5120794,2020.csv,2020,0.0,1.0
2023,The Cherry Bushido,5119325,14182,5105143,2022.csv,2022,0.0027702870983967614,0.9972297129016032
2024,Masked Ward,5107013,0,5107013,2020.csv,2020,0.0,1.0
2025,Ayyappanum Koshiyum,5088713,0,5088713,2020.csv,2020,0.0,1.0
2026,Baba Parasi,5084342,0,5084342,2020.csv,2020,0.0,1.0
2027,Die Känguru-Chroniken,5081127,0,5081127,2020.csv,2020,0.0,1.0
2028,The Real Exorcist,5035830,0,5035830,2020.csv,2020,0.0,1.0
2029,Mayday,5011408,0,5011408,2020.csv,2020,0.0,1.0
2030,Bheeshma,4997080,0,4997080,2020.csv,2020,0.0,1.0
2031,Made in Abyss: Dawn of the Deep Soul,4971635,0,4971635,2020.csv,2020,0.0,1.0
2032,Godai - The Wunderkind,4948225,0,4948225,2020.csv,2020,0.0,1.0
2033,Military Wives,4889252,0,4889252,2020.csv,2020,0.0,1.0
2034,Panga,4886124,582720,4303404,2020.csv,2020,0.11926017432222351,0.8807398256777765
2035,The Tales for Old and Young,4853143,0,4853143,2020.csv,2020,0.0,1.0
2036,Streltsov,4850073,0,4850073,2020.csv,2020,0.0,1.0
2037,The SpongeBob Movie: Sponge on the Run,4810790,4810790,0,2020.csv,2020,1.0,0.0
2038,The Empty Man,4796993,2992948,1804045,2020.csv,2020,0.6239216942780613,0.37607830572193873
2039,The Vets,4788826,0,4788826,2020.csv,2020,0.0,1.0
2040,The Broken Hearts Gallery,4781389,4067442,713947,2020.csv,2020,0.8506820925885763,0.14931790741142376
2041,Gladiator 20th Anniversary,4780585,0,4780585,2020.csv,2020,0.0,1.0
2042,The Cursed,4588389,4588389,0,2022.csv,2022,1.0,0.0
2043,Waiting for Bojangles,4472077,0,4472077,2022.csv,2022,0.0,1.0
2044,Ambulance,4274000,0,4274000,2022.csv,2022,0.0,1.0
2045,Pawankhind,4260686,0,4260686,2022.csv,2022,0.0,1.0
2046,The Godfather 2022 Re-release,4214662,1414662,2800000,2022.csv,2022,0.33565253868518996,0.66434746131481
2047,Maigret,3974524,0,3974524,2022.csv,2022,0.0,1.0
2048,Koniec swiata czyli Kogel Mogel 4,3957350,0,3957350,2022.csv,2022,0.0,1.0
2049,Beautiful Minds,3651250,0,3651250,2022.csv,2022,0.0,1.0
2050,Un Autre Monde,3570119,0,3570119,2022.csv,2022,0.0,1.0
2051,Special Delivery,3536617,0,3536617,2022.csv,2022,0.0,1.0
2052,King,3516803,0,3516803,2022.csv,2022,0.0,1.0
2053,Belli ciao,3423847,0,3423847,2022.csv,2022,0.0,1.0
2054,Between Two Worlds,3317253,0,3317253,2022.csv,2022,0.0,1.0
2055,Goliath,3276852,0,3276852,2022.csv,2022,0.0,1.0
2056,Etharkkum Thunindhavan,3264667,0,3264667,2022.csv,2022,0.0,1.0
2057,Ox-Head Village,3250402,0,3250402,2022.csv,2022,0.0,1.0
2058,Gangubai Kathiawadi,3192000,592000,2600000,2022.csv,2022,0.18546365914786966,0.8145363408521303
2059,In Our Prime,3026664,0,3026664,2022.csv,2022,0.0,1.0
2060,Studio 666,2988867,2513963,474904,2022.csv,2022,0.8411090222482298,0.15889097775177016
2061,The Young Lovers,2955577,0,2955577,2022.csv,2022,0.0,1.0
2062,Disobedient,2923714,0,2923714,2022.csv,2022,0.0,1.0
2063,Chia Khoa Tram Ty,2851565,0,2851565,2022.csv,2022,0.0,1.0
2064,What to Do with the Dead Kaiju?,2827966,0,2827966,2022.csv,2022,0.0,1.0
2065,Permis de construire,2717103,0,2717103,2022.csv,2022,0.0,1.0
2066,¡Qué Despadre!,2681505,0,2681505,2022.csv,2022,0.0,1.0
2067,The Wannabes,2627605,0,2627605,2022.csv,2022,0.0,1.0
2068,The Glance of Music,2577630,0,2577630,2022.csv,2022,0.0,1.0
2069,Chuyen Ma Gan Nhà,2569119,0,2569119,2022.csv,2022,0.0,1.0
2070,Promises,2533430,0,2533430,2022.csv,2022,0.0,1.0
2071,The Outfit,2332990,2332990,0,2022.csv,2022,1.0,0.0
2072,Ensemble Stars!! Road to Show!!,2287844,0,2287844,2022.csv,2022,0.0,1.0
2073,Mister Knockout,2266585,0,2266585,2022.csv,2022,0.0,1.0
2074,Fireheart,2253914,0,2253914,2022.csv,2022,0.0,1.0
2075,The Exorcism of God,2227318,0,2227318,2022.csv,2022,0.0,1.0
2076,The Beatles: Get Back - The Rooftop Concert,2192440,976712,1215728,2022.csv,2022,0.44549086862126214,0.5545091313787378
2077,Around the World in 80 Days,2164782,0,2164782,2022.csv,2022,0.0,1.0
2078,Notre Dame on Fire,2072569,0,2072569,2022.csv,2022,0.0,1.0
2079,Tajemství staré bambitky 2,2056980,0,2056980,2022.csv,2022,0.0,1.0
2080,The Grandmother,1953729,0,1953729,2022.csv,2022,0.0,1.0
2081,The Beatles: Get Back,1939141,0,1939141,2022.csv,2022,0.0,1.0
2082,Wedding High,1908598,0,1908598,2022.csv,2022,0.0,1.0
2083,Aslan: Hürkus kayip Elmas,1883289,0,1883289,2022.csv,2022,0.0,1.0
2084,Love Mocktail 2,1845639,0,1845639,2022.csv,2022,0.0,1.0
2085,Desperate for Marriage,1808456,0,1808456,2022.csv,2022,0.0,1.0
2086,The King's Daughter,1758963,1758963,0,2022.csv,2022,1.0,0.0
2087,Hridayam,1740483,0,1740483,2022.csv,2022,0.0,1.0
2088,"Love, Sex & Pandemic",1712634,0,1712634,2022.csv,2022,0.0,1.0
2089,Kamen Rider OOO 10th: The Core Medals of Resurrection,1675005,0,1675005,2022.csv,2022,0.0,1.0
2090,Aaraattu,1648155,0,1648155,2022.csv,2022,0.0,1.0
2091,Heart of Oak,1613736,0,1613736,2022.csv,2022,0.0,1.0
2092,2022 Oscar Nominated Short Films: Live Action/2022 Oscar Nominated Short Films: Animation/2022 Oscar Nominated Short Films: Documentary 2022 Oscar Nominated Short Films,1609659,1609659,0,2022.csv,2022,1.0,0.0
2093,Undercover,1601934,0,1601934,2022.csv,2022,0.0,1.0
2094,Gierek,1531831,0,1531831,2022.csv,2022,0.0,1.0
2095,For Ziko,1526578,0,1526578,2022.csv,2022,0.0,1.0
2096,V lete ti poviem,1458597,0,1458597,2022.csv,2022,0.0,1.0
2097,Love Is Better Than Life,1410719,0,1410719,2022.csv,2022,0.0,1.0
2098,Odinnadtsat molchalivykh muzhchin,1381930,0,1381930,2022.csv,2022,0.0,1.0
2099,Umma,1365586,1365586,0,2022.csv,2022,1.0,0.0
2100,Nhà Khong Bán,1271932,0,1271932,2022.csv,2022,0.0,1.0
2101,Dilberay Küçük Dev Kadin,1244893,0,1244893,2022.csv,2022,0.0,1.0
2102,Heart to Heart,1186659,0,1186659,2022.csv,2022,0.0,1.0
2103,Swingers,1168817,0,1168817,2022.csv,2022,0.0,1.0
2104,A Radiant Girl,1154112,0,1154112,2022.csv,2022,0.0,1.0
2105,Badhaai Do,1138046,0,1138046,2022.csv,2022,0.0,1.0
2106,1990,1106702,0,1106702,2022.csv,2022,0.0,1.0
2107,The Butcher's Daughter,1033162,0,1033162,2022.csv,2022,0.0,1.0
2108,Veerame Vaagai Soodum,1024908,0,1024908,2022.csv,2022,0.0,1.0
2109,The Midnight Maiden War,996057,0,996057,2022.csv,2022,0.0,1.0
2110,Aaja Mexico Challiye,976316,0,976316,2022.csv,2022,0.0,1.0
2111,Mali Twist,956475,0,956475,2022.csv,2022,0.0,1.0
2112,The Tiger Rising,941447,835162,106285,2022.csv,2022,0.887104637860655,0.11289536213934508
2113,Leopoldstadt - Nt Live 2022 (Theatre),932689,0,932689,2022.csv,2022,0.0,1.0
2114,Hello Jadoo: The Secret of Jeju Island,864899,0,864899,2022.csv,2022,0.0,1.0
2115,Usogui,855598,0,855598,2022.csv,2022,0.0,1.0
2116,The Family,847236,0,847236,2022.csv,2022,0.0,1.0
2117,Krime Story,845412,0,845412,2022.csv,2022,0.0,1.0
2118,Alors on danse,832682,0,832682,2022.csv,2022,0.0,1.0
2119,The Souvenir,827917,0,827917,2022.csv,2022,0.0,1.0
2120,My Brothers and I,825312,0,825312,2022.csv,2022,0.0,1.0
2121,Kappei,821241,0,821241,2022.csv,2022,0.0,1.0
2122,Zero Fucks Given,805349,0,805349,2022.csv,2022,0.0,1.0
2123,Malnazidos,779798,0,779798,2022.csv,2022,0.0,1.0
2124,Adieu Paris,771286,0,771286,2022.csv,2022,0.0,1.0
2125,Corro da te,761727,0,761727,2022.csv,2022,0.0,1.0
2126,Placés,759453,0,759453,2022.csv,2022,0.0,1.0
2127,The Nan Movie,744947,0,744947,2022.csv,2022,0.0,1.0
2128,Official Competition,742755,0,742755,2022.csv,2022,0.0,1.0
2129,The Ancestral,723811,0,723811,2022.csv,2022,0.0,1.0
2130,Emergency Situation,714805,0,714805,2022.csv,2022,0.0,1.0
2131,FIR,709663,0,709663,2022.csv,2022,0.0,1.0
2132,Boiling Point,705045,0,705045,2022.csv,2022,0.0,1.0
2133,The Companions,704580,0,704580,2022.csv,2022,0.0,1.0
2134,Zlatni decko,695379,0,695379,2022.csv,2022,0.0,1.0
2135,America Latina,693818,0,693818,2022.csv,2022,0.0,1.0
2136,Meppadiyan,691981,0,691981,2022.csv,2022,0.0,1.0
2137,Liubov i blohery,677744,0,677744,2022.csv,2022,0.0,1.0
2138,Lynx,668972,0,668972,2022.csv,2022,0.0,1.0
2139,The Deer King,654789,0,654789,2022.csv,2022,0.0,1.0
2140,Kaptan Pengu ve Arkadaslari 2,643626,0,643626,2022.csv,2022,0.0,1.0
2141,Benden Ne Olur,639014,0,639014,2022.csv,2022,0.0,1.0
2142,Ik wist het,636785,0,636785,2022.csv,2022,0.0,1.0
2143,Zaï Zaï Zaï Zaï,622060,0,622060,2022.csv,2022,0.0,1.0
2144,The Blue Skies at Your Feet,613496,0,613496,2022.csv,2022,0.0,1.0
2145,The Phantom of the Open,601962,0,601962,2022.csv,2022,0.0,1.0
2146,The Contractor,572148,0,572148,2022.csv,2022,0.0,1.0
2147,Serve the People,562293,0,562293,2022.csv,2022,0.0,1.0
2148,Full Time,547708,0,547708,2022.csv,2022,0.0,1.0
2149,Bangarraju,534735,0,534735,2022.csv,2022,0.0,1.0
2150,How I Learned to Fly,525011,0,525011,2022.csv,2022,0.0,1.0
2151,The Book Of Dust - La Belle Sauvage - Nt Live 2022 (Theatre),523838,0,523838,2022.csv,2022,0.0,1.0
2152,Hey Sinamika,521057,0,521057,2022.csv,2022,0.0,1.0
2153,Rabbit Academy: Mission Eggpossible,520382,0,520382,2022.csv,2022,0.0,1.0
2154,Milosc jest blisko,504348,0,504348,2022.csv,2022,0.0,1.0
2155,C'era una volta il crimine,499262,0,499262,2022.csv,2022,0.0,1.0
2156,Ek Love Ya,475499,0,475499,2022.csv,2022,0.0,1.0
2157,Murder Party,453590,0,453590,2022.csv,2022,0.0,1.0
2158,Fruits Basket: Prelude,434280,0,434280,2022.csv,2022,0.0,1.0
2159,Ali & Ava,429226,0,429226,2022.csv,2022,0.0,1.0
2160,The Chef,416658,0,416658,2022.csv,2022,0.0,1.0
2161,"Romeo & Juliet - Roh, London 2022 (Ballet)",407787,0,407787,2022.csv,2022,0.0,1.0
2162,Reunion 2,404599,0,404599,2022.csv,2022,0.0,1.0
2163,Petya na moyata Petya,402438,0,402438,2022.csv,2022,0.0,1.0
2164,Den slepogo valentina,401338,0,401338,2022.csv,2022,0.0,1.0
2165,Prior Convictions,394401,0,394401,2022.csv,2022,0.0,1.0
2166,Betlémské svetlo,393455,0,393455,2022.csv,2022,0.0,1.0
2167,Cuarentones,392895,0,392895,2022.csv,2022,0.0,1.0
2168,Palmyra,389281,0,389281,2022.csv,2022,0.0,1.0
2169,Softie,384058,0,384058,2022.csv,2022,0.0,1.0
2170,Papy,368557,0,368557,2022.csv,2022,0.0,1.0
2171,The Path,358527,0,358527,2022.csv,2022,0.0,1.0
2172,Tyson's Run,358100,358100,0,2022.csv,2022,1.0,0.0
2173,Book of Love,354445,0,354445,2022.csv,2022,0.0,1.0
2174,Nitram,344826,0,344826,2022.csv,2022,0.0,1.0
2175,Miyuki Nakajima Live History 2007-2016,343339,0,343339,2022.csv,2022,0.0,1.0
2176,The Best Weekend,342002,0,342002,2022.csv,2022,0.0,1.0
2177,Thunderbirds Go Go,331934,0,331934,2022.csv,2022,0.0,1.0
2178,Proyecto Emperador,326697,0,326697,2022.csv,2022,0.0,1.0
2179,Un Rabón con Corazón,321899,0,321899,2022.csv,2022,0.0,1.0
2180,Paw Patrol: Mission Xmas,320402,0,320402,2022.csv,2022,0.0,1.0
2181,Clean,318877,318877,0,2022.csv,2022,1.0,0.0
2182,Last Looks,317258,0,317258,2022.csv,2022,0.0,1.0
2183,L'ombra del giorno,308477,0,308477,2022.csv,2022,0.0,1.0
2184,Candlelight Revolution,304558,0,304558,2022.csv,2022,0.0,1.0
2185,Nobody's Hero,304037,0,304037,2022.csv,2022,0.0,1.0
2186,Ex,298884,0,298884,2022.csv,2022,0.0,1.0
2187,Kung Fu Zohra,293188,0,293188,2022.csv,2022,0.0,1.0
2188,Afacanlar: Is Basa Düstü,282375,0,282375,2022.csv,2022,0.0,1.0
2189,Three Times Nothing,281810,0,281810,2022.csv,2022,0.0,1.0
2190,Hall,279937,0,279937,2022.csv,2022,0.0,1.0
2191,Beyond Live Nct: Resonance,266442,0,266442,2022.csv,2022,0.0,1.0
2192,The Sadness,264927,0,264927,2022.csv,2022,0.0,1.0
2193,The Bunker Game,264332,0,264332,2022.csv,2022,0.0,1.0
2194,Infinite Storm,262000,262000,0,2022.csv,2022,1.0,0.0
2195,Secret Name,254609,0,254609,2022.csv,2022,0.0,1.0
2196,The Smurfs: Amazing Adventures,254271,0,254271,2022.csv,2022,0.0,1.0
2197,I Want to Talk About Duras,250010,0,250010,2022.csv,2022,0.0,1.0
2198,A Change of Heart,249827,0,249827,2022.csv,2022,0.0,1.0
2199,Alice,245568,245568,0,2022.csv,2022,1.0,0.0
2200,Naai Sekar,237861,0,237861,2022.csv,2022,0.0,1.0
